ID,Count.StartTime,Count.UnitTypeID,Count.Booked Weight,Count.VGM Weight,Corrected Weight,Variance
14338893,44931,SWAP45,44500,8,8000,36500
14354019,44938,SWAP45,15500,,15500,0
14354019,44938,SWAP45,15500,10,10000,5500
14367927,44944,SWAP45,15500,8,8000,7500
14385117,44951,SWAP45,34500,23,23000,11500
14399258,44957,SWAP45,15500,14,14000,1500
14413136,44963,SWAP45,40000,37,37000,3000
14425855,44967,SWAP45,11000,9,9000,2000
14442409,44973,SWAP45,11000,8,8000,3000
14455164,44978,SWAP45,15500,9,9000,6500
14471753,44985,SWAP45,30000,9,9000,21000
14490274,44992,SWAP45,4500,,4500,0
14490274,44992,SWAP45,4500,9,9000,-4500
14501246,44995,SWAP45,11000,,11000,0
14501246,44995,SWAP45,11000,8,8000,3000
14517032,45001,SWAP45,20000,35,35000,-15000
14533415,45008,SWAP45,12500,,12500,0
14533415,45008,SWAP45,12500,10,10000,2500
14533420,45008,SWAP45,12500,20,20000,-7500
14533420,45008,SWAP45,12500,,12500,0
14517034,45001,SWAP45,30000,26,26000,4000
14501258,44995,SWAP45,11000,20,20000,-9000
14492208,44992,SWAP45,20000,20,20000,0
14474628,44986,SWAP45,10000,8,8000,2000
14459949,44980,SWAP45,40000,35,35000,5000
14459949,44980,SWAP45,40000,,40000,0
14435374,44971,SWAP45,11000,10,10000,1000
14419016,44965,SWAP45,30000,25,25000,5000
14401893,44958,SWAP45,34500,24,24000,10500
14385119,44951,SWAP45,15500,9,9000,6500
14333052,44929,SWAP45,24500,21,21000,3500
14347137,44936,SWAP45,15500,9,9000,6500
14338896,44931,SWAP45,34500,25,25000,9500
14367928,44944,SWAP45,15500,9,9000,6500
14354642,44938,SWAP45,15500,9,9000,6500
14422164,44966,SWAP45,25000,40,40000,-15000
14409288,44960,SWAP45,11000,9,9000,2000
14439186,44972,SWAP45,40000,40,40000,0
14455320,44978,SWAP45,36000,40,40000,-4000
14468615,44984,SWAP45,20000,18,18000,2000
14496455,44994,SWAP45,20000,18,18000,2000
14496455,44994,SWAP45,20000,,20000,0
14481563,44988,SWAP45,11000,9,9000,2000
14511827,44999,SWAP45,31500,9,9000,22500
14511827,44999,SWAP45,31500,,31500,0
14530985,45007,SWAP45,40000,,40000,0
14530985,45007,SWAP45,40000,,40000,0
14534609,45008,SWAP45,33500,40,40000,-6500
14534609,45008,SWAP45,33500,,33500,0
14509250,44999,SWAP45,4500,,4500,0
14509250,44999,SWAP45,4500,9,9000,-4500
14509250,44999,SWAP45,4500,,4500,0
14524282,45005,SWAP45,40000,25,25000,15000
14524282,45005,SWAP45,40000,,40000,0
14481529,44988,SWAP45,11000,9,9000,2000
14493294,44993,SWAP45,4500,5,5000,-500
14468616,44984,SWAP45,20000,18,18000,2000
14436065,44971,SWAP45,40000,39,39000,1000
14450618,44977,SWAP45,30000,26,26000,4000
14419704,44965,SWAP45,40000,34,34000,6000
14404576,44959,SWAP45,6500,9,9000,-2500
14380319,44949,SWAP45,24500,16,16000,8500
14391618,44953,SWAP45,15500,8,8000,7500
14364023,44943,SWAP45,39500,39,39000,500
14344535,44935,SWAP45,15500,8,8000,7500
14329854,44928,SWAP45,34500,32,32000,2500
14347326,44936,SWAP45,34500,29,29000,5500
14333051,44929,SWAP45,39500,40,40000,-500
14362293,44942,SWAP45,44500,32,32000,12500
14388197,44952,SWAP45,44500,,44500,0
14388197,44952,SWAP45,44500,39,39000,5500
14373463,44946,SWAP45,26500,10,10000,16500
14402006,44958,SWAP45,44500,37,37000,7500
14416606,44964,SWAP45,10000,8,8000,2000
14450622,44977,SWAP45,30000,39,39000,-9000
14433090,44970,SWAP45,11000,9,9000,2000
14464033,44981,SWAP45,15000,13,13000,2000
14464033,44981,SWAP45,15000,,15000,0
14477517,44987,SWAP45,11000,9,9000,2000
14477517,44987,SWAP45,11000,,11000,0
14496514,44994,SWAP45,30000,18,18000,12000
14515767,45001,SWAP45,25000,,25000,0
14515767,45001,SWAP45,25000,17,17000,8000
14532974,45007,SWAP45,30000,,30000,0
14532974,45007,SWAP45,30000,28,28000,2000
14526853,45006,SWAP45,11000,22,22000,-11000
14526853,45006,SWAP45,11000,,11000,0
14509892,44999,SWAP45,30000,29,29000,1000
14509892,44999,SWAP45,30000,,30000,0
14486991,44991,SWAP45,30000,38,38000,-8000
14473215,44985,SWAP45,30000,15,15000,15000
14459954,44980,SWAP45,20000,9,9000,11000
14436067,44971,SWAP45,11000,10,10000,1000
14419019,44965,SWAP45,11000,9,9000,2000
14401894,44958,SWAP45,44500,27,27000,17500
14387934,44952,SWAP45,29500,20,20000,9500
14368514,44944,SWAP45,15500,9,9000,6500
14344536,44935,SWAP45,44500,36,36000,8500
14329855,44928,SWAP45,24500,,24500,0
14329855,44928,SWAP45,24500,14,14000,10500
14336282,44930,SWAP45,44500,40,40000,4500
14362215,44942,SWAP45,44500,9,9000,35500
14362215,44942,SWAP45,44500,25,25000,19500
14348354,44936,SWAP45,15500,8,8000,7500
14391520,44953,SWAP45,26500,20,20000,6500
14373464,44946,SWAP45,15500,10,10000,5500
14404812,44959,SWAP45,41000,39,39000,2000
14419708,44965,SWAP45,29000,20,20000,9000
14436069,44971,SWAP45,40000,39,39000,1000
14453666,44978,SWAP45,30000,29,29000,1000
14468754,44984,SWAP45,30000,19,19000,11000
14481566,44988,SWAP45,20000,17,17000,3000
14496516,44994,SWAP45,20000,19,19000,1000
14515769,45001,SWAP45,30000,28,28000,2000
14515769,45001,SWAP45,30000,,30000,0
14533421,45008,SWAP45,30000,,30000,0
14533421,45008,SWAP45,30000,9,9000,21000
14530989,45007,SWAP45,30000,,30000,0
14530989,45007,SWAP45,30000,,30000,0
14534613,45008,SWAP45,23500,,23500,0
14534613,45008,SWAP45,23500,27,27000,-3500
14512864,45000,SWAP45,40000,9,9000,31000
14487004,44991,SWAP45,40000,9,9000,31000
14456994,44979,SWAP45,22000,23,23000,-1000
14472421,44985,SWAP45,40000,32,32000,8000
14439189,44972,SWAP45,12000,8,8000,4000
14422165,44966,SWAP45,30000,23,23000,7000
14404579,44959,SWAP45,31500,20,20000,11500
14380321,44949,SWAP45,15500,8,8000,7500
14391531,44953,SWAP45,15500,8,8000,7500
14350010,44937,SWAP45,29500,17,17000,12500
14365650,44943,SWAP45,15500,9,9000,6500
14336284,44930,SWAP45,34500,18,18000,16500
14344395,44935,SWAP45,24500,18,18000,6500
14329856,44928,SWAP45,24500,18,18000,6500
14369954,44945,SWAP45,34500,27,27000,7500
14356582,44939,SWAP45,26500,20,20000,6500
14356582,44939,SWAP45,26500,,26500,0
14385868,44951,SWAP45,34500,28,28000,6500
14415421,44964,SWAP45,11000,8,8000,3000
14433086,44970,SWAP45,40000,9,9000,31000
14446500,44974,SWAP45,11000,10,10000,1000
14474639,44986,SWAP45,40000,39,39000,1000
14459962,44980,SWAP45,30000,27,27000,3000
14491137,44992,SWAP45,22000,8,8000,14000
14520534,45002,SWAP45,35000,,35000,0
14520534,45002,SWAP45,35000,,35000,0
14520534,45002,SWAP45,35000,40,40000,-5000
14506034,44998,SWAP45,11000,17,17000,-6000
14506034,44998,SWAP45,11000,,11000,0
14534386,45008,SWAP45,11000,,11000,0
14534388,45008,SWAP45,20000,,20000,0
14534388,45008,SWAP45,20000,20,20000,0
14530359,45007,SWAP45,20000,,20000,0
14530359,45007,SWAP45,20000,,20000,0
14512870,45000,SWAP45,30000,24,24000,6000
14496519,44994,SWAP45,12000,9,9000,3000
14496519,44994,SWAP45,12000,,12000,0
14481568,44988,SWAP45,15000,9,9000,6000
14468909,44984,SWAP45,40000,35,35000,5000
14454145,44978,SWAP45,11000,8,8000,3000
14436071,44971,SWAP45,30000,24,24000,6000
14419716,44965,SWAP45,30000,21,21000,9000
14404580,44959,SWAP45,31500,30,30000,1500
14395690,44956,SWAP45,44500,,44500,0
14395690,44956,SWAP45,44500,35,35000,9500
14380324,44949,SWAP45,24500,10,10000,14500
14364024,44943,SWAP45,34500,25,25000,9500
14329857,44928,SWAP45,29500,12,12000,17500
14347140,44936,SWAP45,29500,16,16000,13500
14336258,44930,SWAP45,15500,8,8000,7500
14365565,44943,SWAP45,34500,19,19000,15500
14350029,44937,SWAP45,24500,18,18000,6500
14380325,44949,SWAP45,34500,25,25000,9500
14391620,44953,SWAP45,34500,30,30000,4500
14404056,44958,SWAP45,11000,9,9000,2000
14422166,44966,SWAP45,20000,20,20000,0
14422166,44966,SWAP45,20000,,20000,0
14439190,44972,SWAP45,25000,,25000,0
14439190,44972,SWAP45,25000,34,34000,-9000
14472372,44985,SWAP45,11000,9,9000,2000
14456995,44979,SWAP45,30000,27,27000,3000
14487195,44991,SWAP45,33500,40,40000,-6500
14513935,45000,SWAP45,11000,,11000,0
14513935,45000,SWAP45,11000,8,8000,3000
14530353,45007,SWAP45,11000,,11000,0
14530353,45007,SWAP45,11000,,11000,0
14534324,45008,SWAP45,11000,9,9000,2000
14537437,45009,SWAP45,11000,,11000,0
14524285,45005,SWAP45,40000,36,36000,4000
14506038,44998,SWAP45,30000,20,20000,10000
14490366,44992,SWAP45,4500,,4500,0
14490366,44992,SWAP45,4500,8,8000,-3500
14459948,44980,SWAP45,40000,38,38000,2000
14474646,44986,SWAP45,20000,17,17000,3000
14435377,44971,SWAP45,11000,9,9000,2000
14446664,44974,SWAP45,20000,15,15000,5000
14419719,44965,SWAP45,19000,15,15000,4000
14404813,44959,SWAP45,31000,16,16000,15000
14396146,44956,SWAP45,44500,36,36000,8500
14383102,44950,SWAP45,39500,39,39000,500
14353796,44938,SWAP45,26500,19,19000,7500
14353796,44938,SWAP45,26500,,26500,0
14367362,44944,SWAP45,29500,17,17000,12500
14336260,44930,SWAP45,15500,9,9000,6500
14336262,44930,SWAP45,15500,9,9000,6500
14365657,44943,SWAP45,39500,35,35000,4500
14350022,44937,SWAP45,29500,22,22000,7500
14382342,44950,SWAP45,15500,8,8000,7500
14382342,44950,SWAP45,15500,,15500,0
14407511,44960,SWAP45,25000,,25000,0
14407511,44960,SWAP45,25000,25,25000,0
14422169,44966,SWAP45,30000,20,20000,10000
14454349,44978,SWAP45,11000,9,9000,2000
14439191,44972,SWAP45,40000,31,31000,9000
14468911,44984,SWAP45,40000,42,42000,-2000
14481569,44988,SWAP45,30000,30,30000,0
14496521,44994,SWAP45,11000,,11000,0
14496521,44994,SWAP45,11000,9,9000,2000
14512878,45000,SWAP45,40000,9,9000,31000
14529248,45006,SWAP45,30000,15,15000,15000
14525490,45006,SWAP45,30000,20,20000,10000
14510543,44999,SWAP45,30000,26,26000,4000
14510543,44999,SWAP45,30000,,30000,0
14487196,44991,SWAP45,20500,32,32000,-11500
14468913,44984,SWAP45,11000,9,9000,2000
14455397,44978,SWAP45,26000,19,19000,7000
14439233,44972,SWAP45,20000,,20000,0
14439233,44972,SWAP45,20000,18,18000,2000
14422170,44966,SWAP45,20000,14,14000,6000
14404816,44959,SWAP45,26000,20,20000,6000
14379225,44949,SWAP45,39500,,39500,0
14379225,44949,SWAP45,39500,33,33000,6500
14391623,44953,SWAP45,44500,,44500,0
14391623,44953,SWAP45,44500,9,9000,35500
14348360,44936,SWAP45,15500,17,17000,-1500
14362217,44942,SWAP45,15500,9,9000,6500
14332087,44929,SWAP45,34500,22,22000,12500
14332402,44929,SWAP45,15500,9,9000,6500
14332402,44929,SWAP45,15500,,15500,0
14367364,44944,SWAP45,34500,24,24000,10500
14350513,44937,SWAP45,15500,10,10000,5500
14396149,44956,SWAP45,24500,15,15000,9500
14382344,44950,SWAP45,15500,,15500,0
14382344,44950,SWAP45,15500,9,9000,6500
14404820,44959,SWAP45,21000,9,9000,12000
14419727,44965,SWAP45,40000,41,41000,-1000
14436072,44971,SWAP45,11000,10,10000,1000
14446665,44974,SWAP45,10000,10,10000,0
14463553,44981,SWAP45,12500,8,8000,4500
14477521,44987,SWAP45,11000,,11000,0
14496523,44994,SWAP45,30000,9,9000,21000
14512880,45000,SWAP45,40000,34,34000,6000
14529251,45006,SWAP45,20000,21,21000,-1000
14529252,45006,SWAP45,30000,22,22000,8000
14510546,44999,SWAP45,17000,14,14000,3000
14487199,44991,SWAP45,23500,,23500,0
14487199,44991,SWAP45,23500,31,31000,-7500
14471755,44985,SWAP45,25000,25,25000,0
14457321,44979,SWAP45,40000,35,35000,5000
14441683,44973,SWAP45,20000,17,17000,3000
14425856,44967,SWAP45,40000,28,28000,12000
14414582,44963,SWAP45,30000,27,27000,3000
14399757,44957,SWAP45,39500,40,40000,-500
14385123,44951,SWAP45,24500,38,38000,-13500
14371217,44945,SWAP45,34500,29,29000,5500
14357885,44939,SWAP45,15500,9,9000,6500
14357885,44939,SWAP45,15500,8,8000,7500
14329859,44928,SWAP45,34500,19,19000,15500
14344396,44935,SWAP45,15500,20,20000,-4500
14367933,44944,SWAP45,15500,8,8000,7500
14350013,44937,SWAP45,15500,9,9000,6500
14396152,44956,SWAP45,44500,30,30000,14500
14383109,44950,SWAP45,39500,36,36000,3500
14383109,44950,SWAP45,39500,39,39000,500
14404824,44959,SWAP45,41000,40,40000,1000
14419729,44965,SWAP45,11000,9,9000,2000
14436074,44971,SWAP45,11000,9,9000,2000
14453589,44978,SWAP45,21000,17,17000,4000
14473216,44985,SWAP45,11000,9,9000,2000
14493273,44993,SWAP45,23500,33,33000,-9500
14519522,45002,SWAP45,11000,,11000,0
14519522,45002,SWAP45,11000,,11000,0
14519522,45002,SWAP45,11000,9,9000,2000
14534390,45008,SWAP45,40000,,40000,0
14534390,45008,SWAP45,40000,40,40000,0
14532976,45007,SWAP45,12000,9,9000,3000
14515770,45001,SWAP45,11000,8,8000,3000
14515770,45001,SWAP45,11000,,11000,0
14487203,44991,SWAP45,23500,22,22000,1500
14468914,44984,SWAP45,30000,9,9000,21000
14453660,44978,SWAP45,11000,8,8000,3000
14453660,44978,SWAP45,11000,29,29000,-18000
14435380,44971,SWAP45,25000,27,27000,-2000
14419021,44965,SWAP45,11000,9,9000,2000
14401895,44958,SWAP45,44500,38,38000,6500
14401895,44958,SWAP45,44500,,44500,0
14375201,44946,SWAP45,15500,10,10000,5500
14388224,44952,SWAP45,15500,9,9000,6500
14348363,44936,SWAP45,15500,9,9000,6500
14362219,44942,SWAP45,15500,15,15000,500
14336263,44930,SWAP45,44500,17,17000,27500
14344537,44935,SWAP45,24500,22,22000,2500
14329866,44928,SWAP45,24500,32,32000,-7500
14362227,44942,SWAP45,39500,30,30000,9500
14388225,44952,SWAP45,29500,22,22000,7500
14373465,44946,SWAP45,15500,10,10000,5500
14400007,44957,SWAP45,15500,9,9000,6500
14416609,44964,SWAP45,19000,21,21000,-2000
14433035,44970,SWAP45,20000,20,20000,0
14450623,44977,SWAP45,40000,33,33000,7000
14477524,44987,SWAP45,11000,9,9000,2000
14464034,44981,SWAP45,11000,,11000,0
14464034,44981,SWAP45,11000,8,8000,3000
14496524,44994,SWAP45,30000,241,24100,5900
14512883,45000,SWAP45,30000,28,28000,2000
14512883,45000,SWAP45,30000,,30000,0
14534326,45008,SWAP45,30000,25,25000,5000
14530361,45007,SWAP45,30000,,30000,0
14530361,45007,SWAP45,30000,,30000,0
14528296,45006,SWAP45,11000,8,8000,3000
14510549,44999,SWAP45,23000,25,25000,-2000
14487219,44991,SWAP45,13500,17,17000,-3500
14456998,44979,SWAP45,30000,26,26000,4000
14472373,44985,SWAP45,25000,20,20000,5000
14441685,44973,SWAP45,30000,30,30000,0
14425857,44967,SWAP45,11000,9,9000,2000
14413137,44963,SWAP45,30000,35,35000,-5000
14399732,44957,SWAP45,15500,9,9000,6500
14371263,44945,SWAP45,15500,9,9000,6500
14385125,44951,SWAP45,24500,14,14000,10500
14353148,44938,SWAP45,29500,18,18000,11500
14332094,44929,SWAP45,24500,16,16000,8500
14329871,44928,SWAP45,29500,12,12000,17500
14344538,44935,SWAP45,34500,34,34000,500
14357420,44939,SWAP45,15500,9,9000,6500
14369956,44945,SWAP45,15500,8,8000,7500
14385947,44951,SWAP45,44500,35,35000,9500
14399759,44957,SWAP45,15500,7,7000,8500
14413138,44963,SWAP45,20000,11,11000,9000
14425859,44967,SWAP45,20000,8,8000,12000
14441689,44973,SWAP45,20000,9,9000,11000
14473222,44985,SWAP45,11000,10,10000,1000
14459953,44980,SWAP45,20000,30,30000,-10000
14492236,44992,SWAP45,11000,8,8000,3000
14501259,44995,SWAP45,20000,18,18000,2000
14501259,44995,SWAP45,20000,,20000,0
14493266,44993,SWAP45,23500,9,9000,14500
14515771,45001,SWAP45,25000,18,18000,7000
14455562,44978,SWAP45,30000,11,11000,19000
14464037,44981,SWAP45,11000,8,8000,3000
14477527,44987,SWAP45,40000,40,40000,0
14439235,44972,SWAP45,40000,39,39000,1000
14422172,44966,SWAP45,11000,11,11000,0
14407513,44960,SWAP45,11000,9,9000,2000
14396155,44956,SWAP45,44500,40,40000,4500
14383112,44950,SWAP45,34500,30,30000,4500
14367935,44944,SWAP45,15500,28,28000,-12500
14354645,44938,SWAP45,15500,9,9000,6500
14338898,44931,SWAP45,34500,31,31000,3500
14533423,45008,SWAP45,20000,18,18000,2000
14533423,45008,SWAP45,20000,,20000,0
14533424,45008,SWAP45,30000,,30000,0
14533424,45008,SWAP45,30000,28,28000,2000
14344397,44935,SWAP45,15500,9,9000,6500
14332096,44929,SWAP45,34500,28,28000,6500
14362231,44942,SWAP45,34500,28,28000,6500
14374928,44946,SWAP45,15500,,15500,0
14374928,44946,SWAP45,15500,10,10000,5500
14388201,44952,SWAP45,29500,15,15000,14500
14399760,44957,SWAP45,34500,40,40000,-5500
14415422,44964,SWAP45,25000,27,27000,-2000
14433091,44970,SWAP45,40000,26,26000,14000
14450626,44977,SWAP45,20000,18,18000,2000
14477529,44987,SWAP45,30000,22,22000,8000
14463720,44981,SWAP45,12500,8,8000,4500
14511802,44999,SWAP45,31500,,31500,0
14511802,44999,SWAP45,31500,9,9000,22500
14493264,44993,SWAP45,23500,,23500,0
14493264,44993,SWAP45,23500,28,28000,-4500
14493241,44993,SWAP45,23500,9,9000,14500
14515773,45001,SWAP45,11000,9,9000,2000
14515773,45001,SWAP45,11000,,11000,0
14463808,44981,SWAP45,20500,8,8000,12500
14477531,44987,SWAP45,30000,28,28000,2000
14450627,44977,SWAP45,20000,16,16000,4000
14433958,44970,SWAP45,30000,28,28000,2000
14416611,44964,SWAP45,30000,19,19000,11000
14400154,44957,SWAP45,34500,19,19000,15500
14385948,44951,SWAP45,15500,9,9000,6500
14371219,44945,SWAP45,44500,38,38000,6500
14356584,44939,SWAP45,15500,8,8000,7500
14339580,44931,SWAP45,15500,8,8000,7500
14533425,45008,SWAP45,30000,16,16000,14000
14533011,45007,SWAP45,11000,9,9000,2000
14336264,44930,SWAP45,15500,10,10000,5500
14350023,44937,SWAP45,39500,32,32000,7500
14365498,44943,SWAP45,21500,12,12000,9500
14395691,44956,SWAP45,34500,28,28000,6500
14382345,44950,SWAP45,24500,14,14000,10500
14413061,44963,SWAP45,40000,29,29000,11000
14425860,44967,SWAP45,25000,20,20000,5000
14442410,44973,SWAP45,40000,40,40000,0
14471635,44985,SWAP45,11000,9,9000,2000
14471635,44985,SWAP45,11000,8,8000,3000
14456999,44979,SWAP45,25000,9,9000,16000
14517035,45001,SWAP45,35000,,35000,0
14517035,45001,SWAP45,35000,40,40000,-5000
14492152,44992,SWAP45,11000,8,8000,3000
14501260,44995,SWAP45,30000,25,25000,5000
14493203,44993,SWAP45,4500,9,9000,-4500
14481571,44988,SWAP45,11000,11,11000,0
14509247,44999,SWAP45,18500,21,21000,-2500
14455570,44978,SWAP45,30000,22,22000,8000
14468917,44984,SWAP45,30000,30,30000,0
14439237,44972,SWAP45,30000,22,22000,8000
14422174,44966,SWAP45,11000,9,9000,2000
14407519,44960,SWAP45,20000,17,17000,3000
14380327,44949,SWAP45,15500,9,9000,6500
14391627,44953,SWAP45,44500,35,35000,9500
14364084,44943,SWAP45,24500,14,14000,10500
14347833,44936,SWAP45,15500,9,9000,6500
14333049,44929,SWAP45,29500,20,20000,9500
14529265,45006,SWAP45,35000,38,38000,-3000
14529256,45006,SWAP45,35000,38,38000,-3000
14347344,44936,SWAP45,15500,9,9000,6500
14332133,44929,SWAP45,15500,9,9000,6500
14364025,44943,SWAP45,34500,9,9000,25500
14395692,44956,SWAP45,44500,39,39000,5500
14379737,44949,SWAP45,44500,40,40000,4500
14404582,44959,SWAP45,12500,9,9000,3500
14419730,44965,SWAP45,25000,20,20000,5000
14435382,44971,SWAP45,22000,20,20000,2000
14450630,44977,SWAP45,30000,30,30000,0
14477534,44987,SWAP45,29500,21,21000,8500
14464042,44981,SWAP45,11000,18,18000,-7000
14510552,44999,SWAP45,12000,16,16000,-4000
14492830,44993,SWAP45,12000,12,12000,0
14492830,44993,SWAP45,12000,,12000,0
14493199,44993,SWAP45,23500,25,25000,-1500
14514086,45000,SWAP45,11000,8,8000,3000
14457247,44979,SWAP45,22000,19,19000,3000
14477537,44987,SWAP45,11000,8,8000,3000
14468918,44984,SWAP45,20000,328,32800,-12800
14434963,44970,SWAP45,30000,28,28000,2000
14416615,44964,SWAP45,10000,9,9000,1000
14401896,44958,SWAP45,34500,21,21000,13500
14375204,44946,SWAP45,34500,10,10000,24500
14388165,44952,SWAP45,29500,18,18000,11500
14362232,44942,SWAP45,24500,18,18000,6500
14348364,44936,SWAP45,39500,26,26000,13500
14332966,44929,SWAP45,39500,35,35000,4500
14525816,45005,SWAP45,20000,16,16000,4000
14537439,45009,SWAP45,41000,,41000,0
14526856,45006,SWAP45,30000,8,8000,22000
14526856,45006,SWAP45,30000,,30000,0
14336265,44930,SWAP45,44500,40,40000,4500
14350014,44937,SWAP45,34500,19,19000,15500
14365058,44943,SWAP45,39500,40,40000,-500
14391628,44953,SWAP45,15500,8,8000,7500
14380329,44949,SWAP45,24500,17,17000,7500
14380329,44949,SWAP45,24500,,24500,0
14404588,44959,SWAP45,21500,19,19000,2500
14419731,44965,SWAP45,10000,38,38000,-28000
14436125,44971,SWAP45,30000,9,9000,21000
14472375,44985,SWAP45,35000,35,35000,0
14455575,44978,SWAP45,11000,8,8000,3000
14510553,44999,SWAP45,40000,39,39000,1000
14487225,44991,SWAP45,23500,26,26000,-2500
14481575,44988,SWAP45,25000,18,18000,7000
14493191,44993,SWAP45,23500,14,14000,9500
14509896,44999,SWAP45,32000,32,32000,0
14509896,44999,SWAP45,32000,,32000,0
14457249,44979,SWAP45,20000,18,18000,2000
14468919,44984,SWAP45,40000,35,35000,5000
14468919,44984,SWAP45,40000,,40000,0
14425863,44967,SWAP45,11000,9,9000,2000
14441695,44973,SWAP45,25000,23,23000,2000
14413063,44963,SWAP45,30000,30,30000,0
14383550,44950,SWAP45,24500,,24500,0
14383550,44950,SWAP45,24500,8,8000,16500
14396158,44956,SWAP45,15500,9,9000,6500
14367937,44944,SWAP45,15500,9,9000,6500
14353241,44938,SWAP45,15500,9,9000,6500
14338899,44931,SWAP45,44500,40,40000,4500
14525517,45006,SWAP45,11000,13,13000,-2000
14525517,45006,SWAP45,11000,,11000,0
14529260,45006,SWAP45,35000,33,33000,2000
14338907,44931,SWAP45,24500,18,18000,6500
14354634,44938,SWAP45,15500,10,10000,5500
14367938,44944,SWAP45,34500,8,8000,26500
14396159,44956,SWAP45,34500,30,30000,4500
14396159,44956,SWAP45,34500,30,30000,4500
14383113,44950,SWAP45,27500,32,32000,-4500
14413066,44963,SWAP45,30000,37,37000,-7000
14413066,44963,SWAP45,30000,,30000,0
14442414,44973,SWAP45,20000,13,13000,7000
14425864,44967,SWAP45,11000,8,8000,3000
14468920,44984,SWAP45,20000,40,40000,-20000
14457323,44979,SWAP45,40000,34,34000,6000
14512887,45000,SWAP45,20000,18,18000,2000
14512887,45000,SWAP45,20000,,20000,0
14496528,44994,SWAP45,40000,40,40000,0
14481578,44988,SWAP45,30000,30,30000,0
14490359,44992,SWAP45,6500,11,11000,-4500
14490359,44992,SWAP45,6500,,6500,0
14524199,45005,SWAP45,4500,,4500,0
14524199,45005,SWAP45,4500,8,8000,-3500
14524199,45005,SWAP45,4500,,4500,0
14506111,44998,SWAP45,20000,38,38000,-18000
14459966,44980,SWAP45,11000,28,28000,-17000
14474650,44986,SWAP45,39000,26,26000,13000
14425866,44967,SWAP45,11000,8,8000,3000
14445546,44974,SWAP45,33000,34,34000,-1000
14413071,44963,SWAP45,25000,23,23000,2000
14380330,44949,SWAP45,15500,9,9000,6500
14380330,44949,SWAP45,15500,16,16000,-500
14395693,44956,SWAP45,34500,18,18000,16500
14365659,44943,SWAP45,34500,20,20000,14500
14350025,44937,SWAP45,34500,9,9000,25500
14336266,44930,SWAP45,34500,8,8000,26500
14344539,44935,SWAP45,15500,9,9000,6500
14329875,44928,SWAP45,44500,19,19000,25500
14361380,44942,SWAP45,44500,35,35000,9500
14388203,44952,SWAP45,44500,41,41000,3500
14375208,44946,SWAP45,15500,10,10000,5500
14416616,44964,SWAP45,10000,9,9000,1000
14401889,44958,SWAP45,15500,8,8000,7500
14450632,44977,SWAP45,40000,38,38000,2000
14433975,44970,SWAP45,12000,10,10000,2000
14477540,44987,SWAP45,25000,25,25000,0
14464074,44981,SWAP45,20000,16,16000,4000
14509306,44999,SWAP45,23500,12,12000,11500
14509306,44999,SWAP45,23500,,23500,0
14493185,44993,SWAP45,33500,42,42000,-8500
14493185,44993,SWAP45,33500,,33500,0
14527495,45006,SWAP45,30000,,30000,0
14527495,45006,SWAP45,30000,29,29000,1000
14530363,45007,SWAP45,30000,25,25000,5000
14496529,44994,SWAP45,11000,14,14000,-3000
14512886,45000,SWAP45,20000,15,15000,5000
14512886,45000,SWAP45,20000,,20000,0
14464080,44981,SWAP45,20000,8,8000,12000
14477541,44987,SWAP45,11000,9,9000,2000
14477541,44987,SWAP45,11000,,11000,0
14433999,44970,SWAP45,26000,39,39000,-13000
14450633,44977,SWAP45,20000,26,26000,-6000
14401909,44958,SWAP45,24500,11,11000,13500
14416628,44964,SWAP45,10000,8,8000,2000
14375213,44946,SWAP45,15500,10,10000,5500
14385951,44951,SWAP45,34500,21,21000,13500
14362255,44942,SWAP45,29500,10,10000,19500
14348244,44936,SWAP45,29500,9,9000,20500
14348244,44936,SWAP45,29500,,29500,0
14332361,44929,SWAP45,15500,15,15000,500
14339582,44931,SWAP45,15500,8,8000,7500
14354646,44938,SWAP45,39500,16,16000,23500
14367365,44944,SWAP45,34500,28,28000,6500
14382346,44950,SWAP45,34500,27,27000,7500
14415425,44964,SWAP45,10000,8,8000,2000
14397999,44956,SWAP45,34500,27,27000,7500
14450634,44977,SWAP45,30000,18,18000,12000
14434000,44970,SWAP45,21000,15,15000,6000
14468922,44984,SWAP45,30000,21,21000,9000
14524294,45005,SWAP45,30000,,30000,0
14524294,45005,SWAP45,30000,10,10000,20000
14509244,44999,SWAP45,18500,20,20000,-1500
14493183,44993,SWAP45,4500,9,9000,-4500
14481580,44988,SWAP45,30000,38,38000,-8000
14493181,44993,SWAP45,23500,,23500,0
14493181,44993,SWAP45,23500,40,40000,-16500
14506117,44998,SWAP45,11000,9,9000,2000
14506117,44998,SWAP45,11000,,11000,0
14524295,45005,SWAP45,20000,18,18000,2000
14524295,45005,SWAP45,20000,,20000,0
14474653,44986,SWAP45,40000,8,8000,32000
14460590,44980,SWAP45,4500,9,9000,-4500
14457252,44979,SWAP45,40000,9,9000,31000
14433045,44970,SWAP45,40000,35,35000,5000
14442439,44973,SWAP45,25000,19,19000,6000
14401911,44958,SWAP45,24500,18,18000,6500
14416646,44964,SWAP45,30000,23,23000,7000
14384538,44951,SWAP45,34500,23,23000,11500
14368515,44944,SWAP45,15500,8,8000,7500
14353116,44938,SWAP45,15500,9,9000,6500
14338910,44931,SWAP45,24500,9,9000,15500
14537444,45009,SWAP45,11000,,11000,0
14529264,45006,SWAP45,23000,19,19000,4000
14336267,44930,SWAP45,24500,33,33000,-8500
14350015,44937,SWAP45,34500,25,25000,9500
14367366,44944,SWAP45,24500,21,21000,3500
14382909,44950,SWAP45,15500,11,11000,4500
14396163,44956,SWAP45,34500,28,28000,6500
14413072,44963,SWAP45,30000,21,21000,9000
14425867,44967,SWAP45,30000,28,28000,2000
14439239,44972,SWAP45,11000,8,8000,3000
14455584,44978,SWAP45,30000,26,26000,4000
14464387,44981,SWAP45,11000,8,8000,3000
14512882,45000,SWAP45,40000,27,27000,13000
14496530,44994,SWAP45,70000,9,9000,61000
14481585,44988,SWAP45,40000,9,9000,31000
14480866,44987,SWAP45,11000,9,9000,2000
14496533,44994,SWAP45,20000,9,9000,11000
14512881,45000,SWAP45,11000,39,39000,-28000
14464388,44981,SWAP45,11000,8,8000,3000
14455587,44978,SWAP45,30000,28,28000,2000
14439240,44972,SWAP45,30000,29,29000,1000
14422176,44966,SWAP45,30000,18,18000,12000
14401912,44958,SWAP45,34500,30,30000,4500
14388227,44952,SWAP45,34500,20,20000,14500
14375214,44946,SWAP45,15500,10,10000,5500
14362262,44942,SWAP45,15500,10,10000,5500
14348367,44936,SWAP45,44500,30,30000,14500
14336268,44930,SWAP45,34500,23,23000,11500
14336268,44930,SWAP45,34500,,34500,0
14529266,45006,SWAP45,11000,8,8000,3000
14537446,45009,SWAP45,41000,,41000,0
14344399,44935,SWAP45,29500,15,15000,14500
14329877,44928,SWAP45,24500,14,14000,10500
14356586,44939,SWAP45,34500,19,19000,15500
14369959,44945,SWAP45,15500,9,9000,6500
14369959,44945,SWAP45,15500,8,8000,7500
14385130,44951,SWAP45,24500,15,15000,9500
14399127,44957,SWAP45,15500,9,9000,6500
14416693,44964,SWAP45,40000,41,41000,-1000
14433047,44970,SWAP45,30000,28,28000,2000
14450636,44977,SWAP45,30000,29,29000,1000
14464399,44981,SWAP45,11000,8,8000,3000
14477544,44987,SWAP45,25000,20,20000,5000
14524297,45005,SWAP45,25000,,25000,0
14524297,45005,SWAP45,25000,26,26000,-1000
14508828,44998,SWAP45,11000,,11000,0
14508828,44998,SWAP45,11000,16,16000,-5000
14508828,44998,SWAP45,11000,,11000,0
14493164,44993,SWAP45,23500,24,24000,-500
14487229,44991,SWAP45,23500,40,40000,-16500
14510419,44999,SWAP45,12500,,12500,0
14510419,44999,SWAP45,12500,9,9000,3500
14524298,45005,SWAP45,20000,27,27000,-7000
14472377,44985,SWAP45,11000,11,11000,0
14455563,44978,SWAP45,4500,9,9000,-4500
14441700,44973,SWAP45,11000,9,9000,2000
14425868,44967,SWAP45,20000,18,18000,2000
14413073,44963,SWAP45,20000,18,18000,2000
14382913,44950,SWAP45,15500,8,8000,7500
14396164,44956,SWAP45,15500,9,9000,6500
14367368,44944,SWAP45,24500,14,14000,10500
14354651,44938,SWAP45,20500,17,17000,3500
14339583,44931,SWAP45,29500,9,9000,20500
14536948,45009,SWAP45,11000,,11000,0
14536954,45009,SWAP45,28000,,28000,0
14344540,44935,SWAP45,34500,27,27000,7500
14329878,44928,SWAP45,34500,34,34000,500
14358154,44939,SWAP45,15500,8,8000,7500
14391518,44953,SWAP45,15500,8,8000,7500
14375144,44946,SWAP45,15500,10,10000,5500
14422181,44966,SWAP45,35000,25,25000,10000
14404053,44958,SWAP45,11000,9,9000,2000
14439251,44972,SWAP45,20000,20,20000,0
14455590,44978,SWAP45,11000,8,8000,3000
14468923,44984,SWAP45,40000,40,40000,0
14524301,45005,SWAP45,20000,20,20000,0
14524301,45005,SWAP45,20000,,20000,0
14506122,44998,SWAP45,11000,11,11000,0
14481586,44988,SWAP45,11000,8,8000,3000
14493159,44993,SWAP45,33500,39,39000,-5500
14493158,44993,SWAP45,33500,14,14000,19500
14512879,45000,SWAP45,40000,30,30000,10000
14477545,44987,SWAP45,25000,15,15000,10000
14464400,44981,SWAP45,11000,9,9000,2000
14464400,44981,SWAP45,11000,9,9000,2000
14435385,44971,SWAP45,15000,12,12000,3000
14453590,44978,SWAP45,30000,32,32000,-2000
14404589,44959,SWAP45,41500,41,41000,500
14419736,44965,SWAP45,11000,21,21000,-10000
14380333,44949,SWAP45,34500,8,8000,26500
14395695,44956,SWAP45,24500,18,18000,6500
14395695,44956,SWAP45,24500,,24500,0
14365660,44943,SWAP45,15500,11,11000,4500
14350522,44937,SWAP45,34500,15,15000,19500
14336269,44930,SWAP45,34500,28,28000,6500
14529268,45006,SWAP45,40000,31,31000,9000
14536958,45009,SWAP45,40000,,40000,0
14536958,45009,SWAP45,40000,,40000,0
14536958,45009,SWAP45,40000,,40000,0
14333013,44929,SWAP45,4500,9,9000,-4500
14350524,44937,SWAP45,15500,11,11000,4500
14365662,44943,SWAP45,15500,9,9000,6500
14391533,44953,SWAP45,15500,9,9000,6500
14379228,44949,SWAP45,24500,20,20000,4500
14422182,44966,SWAP45,40000,32,32000,8000
14404057,44958,SWAP45,11000,10,10000,1000
14439258,44972,SWAP45,30000,22,22000,8000
14464405,44981,SWAP45,11000,8,8000,3000
14455617,44978,SWAP45,40000,39,39000,1000
14477546,44987,SWAP45,11000,9,9000,2000
14477546,44987,SWAP45,11000,,11000,0
14519524,45002,SWAP45,30000,28,28000,2000
14519524,45002,SWAP45,30000,,30000,0
14519524,45002,SWAP45,30000,,30000,0
14501261,44995,SWAP45,19500,9,9000,10500
14490368,44992,SWAP45,23500,30,30000,-6500
14490368,44992,SWAP45,23500,,23500,0
14520576,45002,SWAP45,30000,31,31000,-1000
14520576,45002,SWAP45,30000,,30000,0
14520576,45002,SWAP45,30000,,30000,0
14506123,44998,SWAP45,40000,25,25000,15000
14474654,44986,SWAP45,40000,,40000,0
14474654,44986,SWAP45,40000,27,27000,13000
14455564,44978,SWAP45,4500,9,9000,-4500
14460583,44980,SWAP45,4500,9,9000,-4500
14439271,44972,SWAP45,20000,14,14000,6000
14404058,44958,SWAP45,11000,9,9000,2000
14422184,44966,SWAP45,40000,25,25000,15000
14379739,44949,SWAP45,44500,41,41000,3500
14391534,44953,SWAP45,34500,30,30000,4500
14361384,44942,SWAP45,34500,18,18000,16500
14344543,44935,SWAP45,15500,9,9000,6500
14329880,44928,SWAP45,15500,9,9000,6500
14534394,45008,SWAP45,25000,35,35000,-10000
14533426,45008,SWAP45,11000,9,9000,2000
14533426,45008,SWAP45,11000,,11000,0
14329890,44928,SWAP45,44500,32,32000,12500
14345421,44935,SWAP45,29500,17,17000,12500
14362283,44942,SWAP45,24500,18,18000,6500
14388167,44952,SWAP45,24500,15,15000,9500
14375215,44946,SWAP45,44500,10,10000,34500
14415426,44964,SWAP45,25000,24,24000,1000
14399762,44957,SWAP45,39500,40,40000,-500
14425869,44967,SWAP45,11000,8,8000,3000
14441702,44973,SWAP45,11000,9,9000,2000
14460578,44980,SWAP45,4500,28,28000,-23500
14457335,44979,SWAP45,11000,26,26000,-15000
14474656,44986,SWAP45,11000,8,8000,3000
14517027,45001,SWAP45,36000,39,39000,-3000
14517027,45001,SWAP45,36000,,36000,0
14501263,44995,SWAP45,25000,,25000,0
14501263,44995,SWAP45,25000,39,39000,-14000
14491229,44992,SWAP45,26000,24,24000,2000
14493148,44993,SWAP45,13500,14,14000,-500
14493148,44993,SWAP45,13500,,13500,0
14524302,45005,SWAP45,30000,,30000,0
14524302,45005,SWAP45,30000,17,17000,13000
14506128,44998,SWAP45,30000,9,9000,21000
14477547,44987,SWAP45,40000,40,40000,0
14464421,44981,SWAP45,22000,20,20000,2000
14452221,44977,SWAP45,21000,36,36000,-15000
14434006,44970,SWAP45,20000,24,24000,-4000
14399764,44957,SWAP45,39500,37,37000,2500
14415431,44964,SWAP45,30000,30,30000,0
14385131,44951,SWAP45,34500,15,15000,19500
14358270,44939,SWAP45,15500,10,10000,5500
14371237,44945,SWAP45,34500,17,17000,17500
14344545,44935,SWAP45,34500,29,29000,5500
14329892,44928,SWAP45,24500,30,30000,-5500
14336271,44930,SWAP45,24500,40,40000,-15500
14365502,44943,SWAP45,44500,34,34000,10500
14350017,44937,SWAP45,15500,17,17000,-1500
14380335,44949,SWAP45,44500,34,34000,10500
14391630,44953,SWAP45,29500,8,8000,21500
14419737,44965,SWAP45,11000,9,9000,2000
14404831,44959,SWAP45,31000,,31000,0
14404831,44959,SWAP45,31000,25,25000,6000
14437919,44971,SWAP45,10000,9,9000,1000
14457254,44979,SWAP45,30000,21,21000,9000
14474657,44986,SWAP45,30000,28,28000,2000
14519527,45002,SWAP45,11000,,11000,0
14519527,45002,SWAP45,11000,,11000,0
14519527,45002,SWAP45,11000,9,9000,2000
14491028,44992,SWAP45,12000,9,9000,3000
14501265,44995,SWAP45,40000,40,40000,0
14534395,45008,SWAP45,11000,9,9000,2000
14534395,45008,SWAP45,11000,,11000,0
14537448,45009,SWAP45,30000,,30000,0
14491373,44992,SWAP45,40000,38,38000,2000
14520578,45002,SWAP45,20000,,20000,0
14520578,45002,SWAP45,20000,22,22000,-2000
14506130,44998,SWAP45,20000,33,33000,-13000
14474658,44986,SWAP45,30000,27,27000,3000
14459975,44980,SWAP45,11000,9,9000,2000
14459975,44980,SWAP45,11000,,11000,0
14425870,44967,SWAP45,11000,8,8000,3000
14444998,44974,SWAP45,20000,34,34000,-14000
14399763,44957,SWAP45,39500,40,40000,-500
14413843,44963,SWAP45,11000,9,9000,2000
14388206,44952,SWAP45,44500,36,36000,8500
14373467,44946,SWAP45,15500,10,10000,5500
14362278,44942,SWAP45,44500,40,40000,4500
14347357,44936,SWAP45,26500,22,22000,4500
14332876,44929,SWAP45,34500,30,30000,4500
14339584,44931,SWAP45,34500,17,17000,17500
14367945,44944,SWAP45,15500,9,9000,6500
14354447,44938,SWAP45,15500,9,9000,6500
14384225,44950,SWAP45,44500,38,38000,6500
14396169,44956,SWAP45,39500,30,30000,9500
14413074,44963,SWAP45,40000,33,33000,7000
14442444,44973,SWAP45,35000,25,25000,10000
14425871,44967,SWAP45,11000,8,8000,3000
14457256,44979,SWAP45,40000,21,21000,19000
14468924,44984,SWAP45,20000,14,14000,6000
14519531,45002,SWAP45,11000,9,9000,2000
14519531,45002,SWAP45,11000,,11000,0
14519531,45002,SWAP45,11000,,11000,0
14496535,44994,SWAP45,30000,,30000,0
14496535,44994,SWAP45,30000,,30000,0
14496535,44994,SWAP45,30000,22,22000,8000
14481587,44988,SWAP45,40000,38,38000,2000
14533428,45008,SWAP45,20000,,20000,0
14533428,45008,SWAP45,20000,20,20000,0
14530366,45007,SWAP45,11000,,11000,0
14530366,45007,SWAP45,11000,,11000,0
14534327,45008,SWAP45,11000,9,9000,2000
14487236,44991,SWAP45,4500,10,10000,-5500
14487236,44991,SWAP45,4500,,4500,0
14512877,45000,SWAP45,11000,9,9000,2000
14471705,44985,SWAP45,12000,9,9000,3000
14457257,44979,SWAP45,20000,28,28000,-8000
14439266,44972,SWAP45,40000,27,27000,13000
14422186,44966,SWAP45,11000,9,9000,2000
14407525,44960,SWAP45,11000,9,9000,2000
14396178,44956,SWAP45,44500,40,40000,4500
14382347,44950,SWAP45,15500,8,8000,7500
14382347,44950,SWAP45,15500,,15500,0
14350532,44937,SWAP45,15500,9,9000,6500
14367372,44944,SWAP45,24500,20,20000,4500
14333219,44930,SWAP45,15500,9,9000,6500
14332099,44929,SWAP45,15500,9,9000,6500
14365566,44943,SWAP45,44500,31,31000,13500
14348371,44936,SWAP45,15500,8,8000,7500
14380337,44949,SWAP45,23500,18,18000,5500
14395697,44956,SWAP45,24500,16,16000,8500
14407527,44960,SWAP45,30000,32,32000,-2000
14422187,44966,SWAP45,30000,20,20000,10000
14439274,44972,SWAP45,40000,41,41000,-1000
14454355,44978,SWAP45,11000,9,9000,2000
14454355,44978,SWAP45,11000,,11000,0
14473225,44985,SWAP45,11000,9,9000,2000
14524303,45005,SWAP45,11000,9,9000,2000
14524303,45005,SWAP45,11000,,11000,0
14506136,44998,SWAP45,25000,,25000,0
14506136,44998,SWAP45,25000,28,28000,-3000
14490376,44992,SWAP45,18500,22,22000,-3500
14487237,44991,SWAP45,33500,30,30000,3500
14510236,44999,SWAP45,11000,,11000,0
14510236,44999,SWAP45,11000,9,9000,2000
14473435,44985,SWAP45,33500,37,37000,-3500
14455622,44978,SWAP45,11000,9,9000,2000
14439278,44972,SWAP45,12500,10,10000,2500
14413850,44963,SWAP45,11000,8,8000,3000
14399151,44957,SWAP45,29500,16,16000,13500
14384210,44950,SWAP45,15500,8,8000,7500
14353807,44938,SWAP45,15500,9,9000,6500
14367946,44944,SWAP45,15500,9,9000,6500
14338912,44931,SWAP45,24500,21,21000,3500
14338912,44931,SWAP45,24500,,24500,0
14528221,45006,SWAP45,11000,9,9000,2000
14534328,45008,SWAP45,30000,30,30000,0
14534328,45008,SWAP45,30000,,30000,0
14534328,45008,SWAP45,30000,28,28000,2000
14344546,44935,SWAP45,15500,9,9000,6500
14329894,44928,SWAP45,15500,9,9000,6500
14369960,44945,SWAP45,24500,14,14000,10500
14358302,44939,SWAP45,44500,29,29000,15500
14385964,44951,SWAP45,15500,8,8000,7500
14400049,44957,SWAP45,15500,9,9000,6500
14416694,44964,SWAP45,40000,32,32000,8000
14433050,44970,SWAP45,40000,31,31000,9000
14444997,44973,SWAP45,30000,,30000,0
14444997,44973,SWAP45,30000,20,20000,10000
14459947,44980,SWAP45,40000,21,21000,19000
14474659,44986,SWAP45,20000,19,19000,1000
14506142,44998,SWAP45,20000,17,17000,3000
14506142,44998,SWAP45,20000,,20000,0
14520582,45002,SWAP45,11000,,11000,0
14520582,45002,SWAP45,11000,,11000,0
14520582,45002,SWAP45,11000,11,11000,0
14490377,44992,SWAP45,4500,,4500,0
14490377,44992,SWAP45,4500,8,8000,-3500
14501271,44995,SWAP45,40000,30,30000,10000
14492229,44992,SWAP45,40000,17,17000,23000
14516740,45001,SWAP45,26500,,26500,0
14516740,45001,SWAP45,26500,22,22000,4500
14474660,44986,SWAP45,11000,8,8000,3000
14459960,44980,SWAP45,30000,9,9000,21000
14446666,44974,SWAP45,40000,8,8000,32000
14436149,44971,SWAP45,35000,21,21000,14000
14419738,44965,SWAP45,11000,9,9000,2000
14404832,44959,SWAP45,21000,17,17000,4000
14391535,44953,SWAP45,15500,9,9000,6500
14380339,44949,SWAP45,41500,38,38000,3500
14364027,44943,SWAP45,39500,33,33000,6500
14348375,44936,SWAP45,34500,31,31000,3500
14333046,44929,SWAP45,34500,17,17000,17500
14532996,45007,SWAP45,11000,,11000,0
14532996,45007,SWAP45,11000,9,9000,2000
14536959,45009,SWAP45,40000,,40000,0
14348380,44936,SWAP45,34500,16,16000,18500
14364034,44943,SWAP45,15500,22,22000,-6500
14380278,44949,SWAP45,34500,17,17000,17500
14380278,44949,SWAP45,34500,,34500,0
14380278,44949,SWAP45,34500,17,17000,17500
14380278,44949,SWAP45,34500,,34500,0
14400156,44957,SWAP45,34500,29,29000,5500
14413852,44963,SWAP45,11000,8,8000,3000
14434009,44970,SWAP45,22000,15,15000,7000
14450641,44977,SWAP45,30000,30,30000,0
14464749,44981,SWAP45,30000,30,30000,0
14464749,44981,SWAP45,30000,29,29000,1000
14477548,44987,SWAP45,11000,9,9000,2000
14520314,45002,SWAP45,35000,,35000,0
14520314,45002,SWAP45,35000,41,41000,-6000
14520314,45002,SWAP45,35000,,35000,0
14503320,44995,SWAP45,11000,8,8000,3000
14506144,44998,SWAP45,20000,37,37000,-17000
14524306,45005,SWAP45,25000,15,15000,10000
14491238,44992,SWAP45,30000,,30000,0
14491238,44992,SWAP45,30000,28,28000,2000
14474661,44986,SWAP45,11000,39,39000,-28000
14459972,44980,SWAP45,11000,9,9000,2000
14459972,44980,SWAP45,11000,,11000,0
14436154,44971,SWAP45,11000,9,9000,2000
14419740,44965,SWAP45,11000,9,9000,2000
14404059,44958,SWAP45,30000,16,16000,14000
14380341,44949,SWAP45,44500,36,36000,8500
14391631,44953,SWAP45,44500,37,37000,7500
14365507,44943,SWAP45,29500,20,20000,9500
14350018,44937,SWAP45,24500,25,25000,-500
14336273,44930,SWAP45,15500,8,8000,7500
14537452,45009,SWAP45,11000,,11000,0
14531003,45007,SWAP45,40000,,40000,0
14531003,45007,SWAP45,40000,38,38000,2000
14336274,44930,SWAP45,15500,9,9000,6500
14350027,44937,SWAP45,15500,9,9000,6500
14365642,44943,SWAP45,24500,21,21000,3500
14391634,44953,SWAP45,15500,8,8000,7500
14380342,44949,SWAP45,24500,15,15000,9500
14401916,44958,SWAP45,15500,9,9000,6500
14419027,44965,SWAP45,11000,9,9000,2000
14436156,44971,SWAP45,30000,17,17000,13000
14454356,44978,SWAP45,11000,8,8000,3000
14468927,44984,SWAP45,30000,9,9000,21000
14481593,44988,SWAP45,40000,21,21000,19000
14481593,44988,SWAP45,40000,22,22000,18000
14514888,45000,SWAP45,13500,8,8000,5500
14519533,45002,SWAP45,11000,,11000,0
14519533,45002,SWAP45,11000,,11000,0
14519533,45002,SWAP45,11000,9,9000,2000
14492202,44992,SWAP45,35000,39,39000,-4000
14501275,44995,SWAP45,8000,8,8000,0
14501275,44995,SWAP45,8000,,8000,0
14474662,44986,SWAP45,11000,8,8000,3000
14459970,44980,SWAP45,11000,,11000,0
14459970,44980,SWAP45,11000,9,9000,2000
14435389,44971,SWAP45,30000,22,22000,8000
14419030,44965,SWAP45,20000,20,20000,0
14401926,44958,SWAP45,44500,36,36000,8500
14373468,44946,SWAP45,24500,10,10000,14500
14373468,44946,SWAP45,24500,,24500,0
14388207,44952,SWAP45,15500,9,9000,6500
14388207,44952,SWAP45,15500,,15500,0
14362295,44942,SWAP45,44500,37,37000,7500
14347834,44936,SWAP45,29500,16,16000,13500
14333045,44929,SWAP45,29500,30,30000,-500
14534402,45008,SWAP45,11000,,11000,0
14534402,45008,SWAP45,11000,10,10000,1000
14533019,45007,SWAP45,4500,9,9000,-4500
14339585,44931,SWAP45,15500,8,8000,7500
14353332,44938,SWAP45,34500,23,23000,11500
14367957,44944,SWAP45,15500,9,9000,6500
14385133,44951,SWAP45,24500,21,21000,3500
14385133,44951,SWAP45,24500,20,20000,4500
14398888,44957,SWAP45,15500,9,9000,6500
14416648,44964,SWAP45,27000,17,17000,10000
14433051,44970,SWAP45,30000,18,18000,12000
14450642,44977,SWAP45,40000,39,39000,1000
14464390,44981,SWAP45,30000,27,27000,3000
14474663,44986,SWAP45,30000,8,8000,22000
14501279,44995,SWAP45,40000,39,39000,1000
14490949,44992,SWAP45,11000,10,10000,1000
14517037,45001,SWAP45,16000,15,15000,1000
14517037,45001,SWAP45,16000,,16000,0
14510558,44999,SWAP45,12000,,12000,0
14510558,44999,SWAP45,12000,12,12000,0
14486689,44991,SWAP45,24500,,24500,0
14486689,44991,SWAP45,24500,19,19000,5500
14468928,44984,SWAP45,11000,28,28000,-17000
14454358,44978,SWAP45,11000,9,9000,2000
14435396,44971,SWAP45,30000,28,28000,2000
14419034,44965,SWAP45,30000,23,23000,7000
14401929,44958,SWAP45,19500,12,12000,7500
14387935,44952,SWAP45,24500,18,18000,6500
14369963,44945,SWAP45,24500,19,19000,5500
14357492,44939,SWAP45,34500,28,28000,6500
14344547,44935,SWAP45,24500,16,16000,8500
14329895,44928,SWAP45,39500,18,18000,21500
14528341,45006,SWAP45,11000,9,9000,2000
14534405,45008,SWAP45,20000,20,20000,0
14534405,45008,SWAP45,20000,,20000,0
14530368,45007,SWAP45,20000,,20000,0
14530368,45007,SWAP45,20000,,20000,0
14329897,44928,SWAP45,15500,15,15000,500
14344549,44935,SWAP45,15500,8,8000,7500
14361171,44942,SWAP45,24500,19,19000,5500
14388168,44952,SWAP45,34500,27,27000,7500
14373469,44946,SWAP45,34500,10,10000,24500
14401933,44958,SWAP45,29500,23,23000,6500
14415432,44964,SWAP45,40000,8,8000,32000
14434012,44970,SWAP45,40000,41,41000,-1000
14450643,44977,SWAP45,20000,14,14000,6000
14477551,44987,SWAP45,11000,9,9000,2000
14464417,44981,SWAP45,12000,9,9000,3000
14496540,44994,SWAP45,40000,40,40000,0
14512873,45000,SWAP45,40000,40,40000,0
14512873,45000,SWAP45,40000,,40000,0
14524314,45005,SWAP45,40000,,40000,0
14524314,45005,SWAP45,40000,9,9000,31000
14510571,44999,SWAP45,35000,34,34000,1000
14487241,44991,SWAP45,13500,20,20000,-6500
14459959,44980,SWAP45,30000,18,18000,12000
14473227,44985,SWAP45,26000,30,30000,-4000
14444237,44973,SWAP45,40000,40,40000,0
14399766,44957,SWAP45,44500,40,40000,4500
14385966,44951,SWAP45,44500,9,9000,35500
14371239,44945,SWAP45,15500,9,9000,6500
14357433,44939,SWAP45,15500,9,9000,6500
14344550,44935,SWAP45,24500,25,25000,-500
14329903,44928,SWAP45,34500,27,27000,7500
14332100,44929,SWAP45,24500,15,15000,9500
14347289,44936,SWAP45,15500,9,9000,6500
14362280,44942,SWAP45,34500,28,28000,6500
14388230,44952,SWAP45,15500,9,9000,6500
14375218,44946,SWAP45,15500,10,10000,5500
14402007,44958,SWAP45,44500,39,39000,5500
14415434,44964,SWAP45,25000,15,15000,10000
14450645,44977,SWAP45,40000,40,40000,0
14434014,44970,SWAP45,12000,10,10000,2000
14477553,44987,SWAP45,20000,,20000,0
14477553,44987,SWAP45,20000,18,18000,2000
14464424,44981,SWAP45,32000,,32000,0
14464424,44981,SWAP45,32000,28,28000,4000
14493144,44993,SWAP45,23500,34,34000,-10500
14509241,44999,SWAP45,4500,9,9000,-4500
14509241,44999,SWAP45,4500,,4500,0
14509241,44999,SWAP45,4500,,4500,0
14524317,45005,SWAP45,20000,11,11000,9000
14537455,45009,SWAP45,11000,,11000,0
14535443,45008,SWAP45,11000,9,9000,2000
14520587,45002,SWAP45,30000,28,28000,2000
14506146,44998,SWAP45,25000,28,28000,-3000
14491254,44992,SWAP45,25000,18,18000,7000
14464427,44981,SWAP45,11000,9,9000,2000
14474664,44986,SWAP45,11000,14,14000,-3000
14433010,44970,SWAP45,40000,40,40000,0
14450646,44977,SWAP45,40000,9,9000,31000
14416653,44964,SWAP45,30000,32,32000,-2000
14401934,44958,SWAP45,39500,24,24000,15500
14375222,44946,SWAP45,15500,10,10000,5500
14388208,44952,SWAP45,15500,10,10000,5500
14362282,44942,SWAP45,24500,15,15000,9500
14347143,44936,SWAP45,34500,22,22000,12500
14333021,44929,SWAP45,29500,24,24000,5500
14329904,44928,SWAP45,44500,36,36000,8500
14369970,44945,SWAP45,34500,28,28000,6500
14357643,44939,SWAP45,15500,9,9000,6500
14385969,44951,SWAP45,15500,9,9000,6500
14399767,44957,SWAP45,29500,20,20000,9500
14413853,44963,SWAP45,25000,9,9000,16000
14454361,44978,SWAP45,11000,8,8000,3000
14436161,44971,SWAP45,11000,10,10000,1000
14468930,44984,SWAP45,30000,24,24000,6000
14486782,44991,SWAP45,4500,9,9000,-4500
14486782,44991,SWAP45,4500,,4500,0
14512871,45000,SWAP45,11000,17,17000,-6000
14530369,45007,SWAP45,11000,,11000,0
14530369,45007,SWAP45,11000,38,38000,-27000
14534408,45008,SWAP45,11000,24,24000,-13000
14520589,45002,SWAP45,11000,9,9000,2000
14520589,45002,SWAP45,11000,,11000,0
14520589,45002,SWAP45,11000,,11000,0
14506148,44998,SWAP45,40000,17,17000,23000
14490382,44992,SWAP45,13500,18,18000,-4500
14471757,44985,SWAP45,25000,23,23000,2000
14457336,44979,SWAP45,30000,17,17000,13000
14425874,44967,SWAP45,20000,17,17000,3000
14442453,44973,SWAP45,40000,8,8000,32000
14413139,44963,SWAP45,20000,17,17000,3000
14398562,44957,SWAP45,15500,9,9000,6500
14383114,44950,SWAP45,29500,18,18000,11500
14353213,44938,SWAP45,26500,19,19000,7500
14367975,44944,SWAP45,15500,8,8000,7500
14338920,44931,SWAP45,39500,14,14000,25500
14339587,44931,SWAP45,15500,8,8000,7500
14367979,44944,SWAP45,44500,16,16000,28500
14354655,44938,SWAP45,15500,9,9000,6500
14383115,44950,SWAP45,26500,21,21000,5500
14395698,44956,SWAP45,24500,16,16000,8500
14413075,44963,SWAP45,20000,20,20000,0
14442455,44973,SWAP45,11000,41,41000,-30000
14425876,44967,SWAP45,30000,26,26000,4000
14457250,44979,SWAP45,40000,9,9000,31000
14471828,44985,SWAP45,12000,10,10000,2000
14493135,44993,SWAP45,13500,20,20000,-6500
14493135,44993,SWAP45,13500,,13500,0
14508726,44998,SWAP45,29500,,29500,0
14508726,44998,SWAP45,29500,29,29000,500
14508726,44998,SWAP45,29500,,29500,0
14536963,45009,SWAP45,20000,,20000,0
14524469,45005,SWAP45,11000,40,40000,-29000
14524469,45005,SWAP45,11000,,11000,0
14534409,45008,SWAP45,11000,11,11000,0
14506155,44998,SWAP45,20000,22,22000,-2000
14506155,44998,SWAP45,20000,,20000,0
14520605,45002,SWAP45,35000,25,25000,10000
14491417,44992,SWAP45,40000,38,38000,2000
14474665,44986,SWAP45,29500,25,25000,4500
14459958,44980,SWAP45,30000,21,21000,9000
14425877,44967,SWAP45,11000,9,9000,2000
14442457,44973,SWAP45,30000,24,24000,6000
14413859,44963,SWAP45,30000,20,20000,10000
14399390,44957,SWAP45,34500,29,29000,5500
14385972,44951,SWAP45,15500,41,41000,-25500
14356580,44939,SWAP45,15500,9,9000,6500
14369977,44945,SWAP45,24500,19,19000,5500
14339588,44931,SWAP45,15500,8,8000,7500
14332404,44929,SWAP45,15500,9,9000,6500
14332404,44929,SWAP45,15500,,15500,0
14364038,44943,SWAP45,15500,15,15000,500
14348384,44936,SWAP45,15500,8,8000,7500
14391536,44953,SWAP45,24500,,24500,0
14391536,44953,SWAP45,24500,17,17000,7500
14380344,44949,SWAP45,44500,37,37000,7500
14401939,44958,SWAP45,15500,8,8000,7500
14419037,44965,SWAP45,30000,30,30000,0
14446663,44974,SWAP45,20000,20,20000,0
14436162,44971,SWAP45,40000,10,10000,30000
14459957,44980,SWAP45,30000,39,39000,-9000
14474666,44986,SWAP45,40000,33,33000,7000
14491295,44992,SWAP45,11000,8,8000,3000
14501280,44995,SWAP45,30000,30,30000,0
14501280,44995,SWAP45,30000,,30000,0
14519536,45002,SWAP45,20000,20,20000,0
14519536,45002,SWAP45,20000,,20000,0
14519536,45002,SWAP45,20000,,20000,0
14534410,45008,SWAP45,11000,9,9000,2000
14534410,45008,SWAP45,11000,,11000,0
14534411,45008,SWAP45,11000,,11000,0
14520611,45002,SWAP45,20000,,20000,0
14520611,45002,SWAP45,20000,,20000,0
14520611,45002,SWAP45,20000,20,20000,0
14510262,44999,SWAP45,11000,9,9000,2000
14510262,44999,SWAP45,11000,,11000,0
14487245,44991,SWAP45,13500,11,11000,2500
14472378,44985,SWAP45,30000,27,27000,3000
14457258,44979,SWAP45,25000,20,20000,5000
14439281,44972,SWAP45,30000,17,17000,13000
14425878,44967,SWAP45,15000,12,12000,3000
14413142,44963,SWAP45,30000,30,30000,0
14399743,44957,SWAP45,15500,9,9000,6500
14386009,44951,SWAP45,34500,27,27000,7500
14358167,44939,SWAP45,34500,30,30000,4500
14371241,44945,SWAP45,29500,17,17000,12500
14329906,44928,SWAP45,15500,15,15000,500
14344552,44935,SWAP45,34500,20,20000,14500
14336276,44930,SWAP45,44500,22,22000,22500
14367375,44944,SWAP45,15500,10,10000,5500
14350020,44937,SWAP45,34500,29,29000,5500
14383544,44950,SWAP45,15500,9,9000,6500
14399154,44957,SWAP45,29500,21,21000,8500
14414795,44963,SWAP45,11000,8,8000,3000
14433054,44970,SWAP45,20000,19,19000,1000
14498067,44994,SWAP45,23500,24,24000,-500
14512869,45000,SWAP45,30000,30,30000,0
14534624,45008,SWAP45,33500,42,42000,-8500
14534624,45008,SWAP45,33500,,33500,0
14531006,45007,SWAP45,40000,,40000,0
14531006,45007,SWAP45,40000,,40000,0
14529269,45006,SWAP45,30000,32,32000,-2000
14512868,45000,SWAP45,35000,26,26000,9000
14496542,44994,SWAP45,11050,12,12000,-950
14481595,44988,SWAP45,11000,9,9000,2000
14434032,44970,SWAP45,40000,38,38000,2000
14452259,44977,SWAP45,21000,32,32000,-11000
14468931,44984,SWAP45,30000,29,29000,1000
14415436,44964,SWAP45,15000,12,12000,3000
14398031,44956,SWAP45,15500,10,10000,5500
14383545,44950,SWAP45,29500,8,8000,21500
14354656,44938,SWAP45,34500,30,30000,4500
14367984,44944,SWAP45,44500,30,30000,14500
14339589,44931,SWAP45,15500,8,8000,7500
14375238,44946,SWAP20,13000,8,8000,5000
14469729,44984,SWAP20,24000,24,24000,0
14446669,44974,SWAP20,5000,6,6000,-1000
14487913,44991,SWAP20,10000,7,7000,3000
14437712,44971,SWAP20,5000,5,5000,0
14405140,44959,SWAP20,5000,5,5000,0
14419040,44965,SWAP20,5000,4,4000,1000
14407754,44960,SWAP20,5000,5,5000,0
14386011,44951,SWAP20,8000,4,4000,4000
14397262,44956,SWAP20,18000,16,16000,2000
14371257,44945,SWAP20,8000,4,4000,4000
14425719,44967,SWAP20,3000,4,4000,-1000
14451038,44977,SWAP20,3000,4,4000,-1000
14464002,44981,SWAP20,3000,4,4000,-1000
14528122,45006,SWAP20,13000,9,9000,4000
14365572,44943,SWAP20,8000,4,4000,4000
14396134,44956,SWAP20,15000,10,10000,5000
14380348,44949,SWAP20,14000,11,11000,3000
14461503,44980,SWAP20,12000,12,12000,0
14509212,44999,SWAP20,12000,8,8000,4000
14388824,44952,SWAP20,18000,18,18000,0
14507831,44998,SWAP20,12000,7,7000,5000
14426391,44967,SWAP20,8000,12,12000,-4000
14438724,44972,SWAP20,8000,9,9000,-1000
14436746,44971,SWAP20,11000,9,9000,2000
14416388,44964,SWAP20,5000,5,5000,0
14352579,44938,SWAP20,10000,10,10000,0
14411988,44963,SWAP20,5000,4,4000,1000
14398850,44957,SWAP20,12000,10,10000,2000
14425720,44967,SWAP20,3000,4,4000,-1000
14442279,44973,SWAP20,5000,4,4000,1000
14457260,44979,SWAP20,5000,4,4000,1000
14478994,44987,SWAP20,10000,6,6000,4000
14496889,44994,SWAP20,17000,15,15000,2000
14419042,44965,SWAP20,5000,5,5000,0
14469731,44984,SWAP20,11000,8,8000,3000
14534421,45008,SWAP20,12000,12,12000,0
14525796,45005,SWAP20,5000,5,5000,0
14425829,44967,SWAP20,13000,5,5000,8000
14436747,44971,SWAP20,10000,7,7000,3000
14506874,44998,SWAP20,10000,9,9000,1000
14510526,44999,SWAP20,11000,9,9000,2000
14446670,44974,SWAP20,5000,6,6000,-1000
14465535,44983,SWAP20,12000,7,7000,5000
14525401,45005,SWAP20,14000,11,11000,3000
14537414,45009,SWAP20,15000,,15000,0
14532785,45007,SWAP20,9000,9,9000,0
14444867,44973,SWAP20,10000,8,8000,2000
14425698,44967,SWAP20,12000,16,16000,-4000
14396048,44956,SWAP20,13000,10,10000,3000
14454383,44978,SWAP20,3000,4,4000,-1000
14468833,44984,SWAP20,10000,10,10000,0
14529460,45006,SWAP20,5000,3,3000,2000
14528228,45006,SWAP20,15000,17,17000,-2000
14502892,44995,SWAP20,15000,17,17000,-2000
14382739,44950,SWAP20,13000,17,17000,-4000
14364673,44943,SWAP20,10000,6,6000,4000
14367668,44944,SWAP20,18000,8,8000,10000
14514088,45000,SWAP20,6000,7,7000,-1000
14493581,44993,SWAP20,10000,10,10000,0
14529597,45006,SWAP20,15000,,15000,0
14529597,45006,SWAP20,15000,17,17000,-2000
14493588,44993,SWAP20,6000,8,8000,-2000
14331762,44929,SWAP20,15000,15,15000,0
14371768,44945,SWAP20,13000,8,8000,5000
14422381,44966,SWAP20,8000,4,4000,4000
14401962,44958,SWAP20,17000,12,12000,5000
14408034,44960,SWAP20,6000,5,5000,1000
14482616,44988,SWAP20,14000,10,10000,4000
14438727,44972,SWAP20,5000,3,3000,2000
14528229,45006,SWAP20,12000,5,5000,7000
14460693,44980,SWAP20,10000,11,11000,-1000
14478996,44987,SWAP20,7000,5,5000,2000
14416839,44964,SWAP20,8000,8,8000,0
14382428,44950,SWAP20,11000,8,8000,3000
14388541,44952,SWAP20,17000,14,14000,3000
14339550,44931,SWAP20,10000,7,7000,3000
14347809,44936,SWAP20,13000,8,8000,5000
14347809,44936,SWAP20,13000,7,7000,6000
14345093,44935,SWAP20,15000,12,12000,3000
14337521,44930,SWAP20,8000,4,4000,4000
14398554,44957,SWAP20,15000,10,10000,5000
14491958,44992,SWAP20,9000,8,8000,1000
14469732,44984,SWAP20,12000,11,11000,1000
14524412,45005,SWAP20,9000,,9000,0
14524412,45005,SWAP20,9000,6,6000,3000
14534424,45008,SWAP20,9000,7,7000,2000
14465519,44983,SWAP20,10000,8,8000,2000
14483004,44988,SWAP20,9000,7,7000,2000
14483004,44988,SWAP20,9000,7,7000,2000
14338911,44931,SWAP20,12000,7,7000,5000
14351274,44937,SWAP20,9000,7,7000,2000
14439757,44981,CON20,2266,2,2000,266
14436527,44971,SWAP20,15000,15,15000,0
14451269,44977,SWAP20,10000,13,13000,-3000
14475725,44986,SWAP20,7000,6,6000,1000
14482941,44988,SWAP20,7000,7,7000,0
14506379,44998,SWAP20,4500,13,13000,-8500
14451272,44977,SWAP20,12500,18,18000,-5500
14434877,44970,SWAP20,12500,17,17000,-4500
14524623,45005,SWAP20,12000,17,17000,-5000
14436528,44971,SWAP20,11000,10,10000,1000
14364665,44943,SWAP20,13000,13,13000,0
14336319,44930,SWAP20,8000,4,4000,4000
14398556,44957,SWAP20,12000,8,8000,4000
14383161,44950,SWAP20,18000,15,15000,3000
14408035,44960,SWAP20,6000,6,6000,0
14423108,44966,SWAP20,8000,5,5000,3000
14423108,44966,SWAP20,8000,,8000,0
14471743,44985,SWAP20,12000,12,12000,0
14520663,45002,SWAP20,15000,16,16000,-1000
14497017,44994,SWAP20,11000,11,11000,0
14497017,44994,SWAP20,11000,11,11000,0
14535535,45008,SWAP20,16000,16,16000,0
14460696,44980,SWAP20,5000,5,5000,0
14460696,44980,SWAP20,5000,,5000,0
14454385,44978,SWAP20,7000,4,4000,3000
14446951,44974,SWAP20,5000,5,5000,0
14424916,44966,SWAP20,14000,12,12000,2000
14405178,44959,SWAP20,11000,11,11000,0
14397033,44956,SWAP20,16000,13,13000,3000
14336557,44930,SWAP20,13000,6,6000,7000
14351681,44937,SWAP20,11000,6,6000,5000
14494451,44993,SWAP20,15000,14,14000,1000
14521221,45002,SWAP20,10000,10,10000,0
14506875,44998,SWAP20,5000,5,5000,0
14506875,44998,SWAP20,5000,,5000,0
14496892,44994,SWAP20,14000,14,14000,0
14436529,44971,SWAP20,5000,5,5000,0
14471726,44985,SWAP20,8000,8,8000,0
14525839,45005,SWAP20,9000,5,5000,4000
14475467,44986,SWAP20,3000,3,3000,0
14462089,44980,SWAP20,3000,4,4000,-1000
14438734,44972,SWAP20,5000,3,3000,2000
14495076,44993,SWAP20,14000,14,14000,0
14491189,44992,SWAP20,14000,16,16000,-2000
14491189,44992,SWAP20,14000,,14000,0
14405867,44959,SWAP20,9000,4,4000,5000
14423002,44966,SWAP20,12000,12,12000,0
14416840,44964,SWAP20,10000,6,6000,4000
14399020,44957,SWAP20,8000,,8000,0
14399020,44957,SWAP20,8000,4,4000,4000
14387263,44951,SWAP20,11000,10,10000,1000
14351027,44937,SWAP20,9000,5,5000,4000
14493949,44993,SWAP20,13000,20,20000,-7000
14513820,45000,SWAP20,10000,7,7000,3000
14436749,44971,SWAP20,11000,10,10000,1000
14461507,44980,SWAP20,15000,15,15000,0
14524624,45005,SWAP20,14000,14,14000,0
14535257,45008,SWAP20,12000,12,12000,0
14535257,45008,SWAP20,12000,,12000,0
14535257,45008,SWAP20,12000,11,11000,1000
14473167,44985,SWAP20,5000,4,4000,1000
14513822,45000,SWAP20,15000,13,13000,2000
14497141,44994,SWAP20,5000,5,5000,0
14483249,44988,SWAP20,3000,4,4000,-1000
14487172,44991,SWAP20,12000,11,11000,1000
14471426,44985,SWAP20,9000,10,10000,-1000
14447116,44974,SWAP20,11000,10,10000,1000
14531800,45007,SWAP20,15000,14,14000,1000
14507218,44998,SWAP20,7000,10,10000,-3000
14502968,44997,SWAP20,12000,11,11000,1000
14482948,44988,SWAP20,16000,16,16000,0
14439236,44972,SWAP20,10000,9,9000,1000
14425700,44967,SWAP20,8000,,8000,0
14425700,44967,SWAP20,8000,9,9000,-1000
14416845,44964,SWAP20,10000,11,11000,-1000
14375241,44946,SWAP20,13000,,13000,0
14375241,44946,SWAP20,13000,10,10000,3000
14364667,44943,SWAP20,13000,8,8000,5000
14347292,44936,SWAP20,11000,10,10000,1000
14339551,44931,SWAP20,15000,14,14000,1000
14330012,44928,SWAP20,13000,10,10000,3000
14433590,44970,SWAP20,15000,17,17000,-2000
14460699,44980,SWAP20,7000,10,10000,-3000
14510469,44999,SWAP20,10000,7,7000,3000
14375289,44946,SWAP20,18000,16,16000,2000
14385609,44951,SWAP20,19000,17,17000,2000
14506895,44998,SWAP20,15000,14,14000,1000
14516950,45001,SWAP20,14000,15,15000,-1000
14492108,44992,SWAP20,14000,15,15000,-1000
14405180,44959,SWAP20,15000,12,12000,3000
14465273,44981,SWAP20,12000,10,10000,2000
14495122,44993,SWAP20,15000,15,15000,0
14513760,45000,SWAP20,10000,18,18000,-8000
14361690,44942,SWAP20,17000,18,18000,-1000
14528123,45006,SWAP20,13000,10,10000,3000
14516874,45001,SWAP20,12000,10,10000,2000
14508723,44998,SWAP20,9000,12,12000,-3000
14442626,44973,SWAP20,10000,8,8000,2000
14419054,44965,SWAP20,12000,12,12000,0
14469733,44984,SWAP20,15000,11,11000,4000
14483006,44990,SWAP20,13000,12,12000,1000
14488099,44991,SWAP20,15000,16,16000,-1000
14502971,44997,SWAP20,15000,16,16000,-1000
14468843,44984,SWAP20,13000,14,14000,-1000
14465525,44983,SWAP20,15000,16,16000,-1000
14433102,44970,SWAP20,10000,8,8000,2000
14482952,44988,SWAP20,12000,14,14000,-2000
14488110,44991,SWAP20,15000,18,18000,-3000
14502586,44995,SWAP20,15000,18,18000,-3000
14502586,44995,SWAP20,15000,,15000,0
14332441,44929,SWAP20,10000,7,7000,3000
14525842,45005,SWAP20,15000,,15000,0
14525842,45005,SWAP20,15000,19,19000,-4000
14347295,44936,SWAP20,18000,15,15000,3000
14356659,44939,SWAP20,15000,18,18000,-3000
14487424,44991,SWAP20,5000,5,5000,0
14336561,44930,SWAP20,11000,7,7000,4000
14480549,44987,SWAP20,12000,10,10000,2000
14525843,45005,SWAP20,15000,13,13000,2000
14479000,44987,SWAP20,10000,14,14000,-4000
14497399,44994,SWAP20,12000,12,12000,0
14475742,44986,SWAP20,6000,5,5000,1000
14379295,44949,SWAP20,14000,10,10000,4000
14490292,44992,SWAP20,15000,8,8000,7000
14496893,44994,SWAP20,9000,9,9000,0
14464669,44981,SWAP20,8000,9,9000,-1000
14465526,44981,SWAP20,5000,5,5000,0
14516991,45001,SWAP20,5000,5,5000,0
14396049,44956,SWAP20,18000,12,12000,6000
14520541,45002,SWAP20,10000,,10000,0
14520541,45002,SWAP20,10000,12,12000,-2000
14531865,45007,SWAP20,10000,10,10000,0
14509857,44999,SWAP20,17000,17,17000,0
14535904,45008,SWAP20,15000,18,18000,-3000
14506391,44998,SWAP20,14000,15,15000,-1000
14520542,45002,SWAP20,14000,14,14000,0
14520542,45002,SWAP20,14000,,14000,0
14371805,44945,SWAP20,8000,5,5000,3000
14351029,44937,SWAP20,3000,12,12000,-9000
14528232,45006,SWAP20,13000,16,16000,-3000
14494985,44993,SWAP20,13000,12,12000,1000
14457632,44979,SWAP20,9000,10,10000,-1000
14475863,44986,SWAP20,15000,10,10000,5000
14488113,44991,SWAP20,5000,6,6000,-1000
14344494,44935,SWAP20,15000,14,14000,1000
14344494,44935,SWAP20,15000,,15000,0
14396050,44956,SWAP20,14000,12,12000,2000
14401971,44958,SWAP20,18000,14,14000,4000
14535947,45008,SWAP20,8000,10,10000,-2000
14368240,44944,SWAP20,8000,6,6000,2000
14516998,45001,SWAP20,11000,10,10000,1000
14502898,44995,SWAP20,12000,12,12000,0
14497417,44994,SWAP20,12000,13,13000,-1000
14493422,44993,SWAP20,11000,12,12000,-1000
14529286,45006,SWAP20,5000,5,5000,0
14514111,45000,SWAP20,16000,20,20000,-4000
14454386,44978,SWAP20,10000,8,8000,2000
14478531,44987,SWAP20,11000,13,13000,-2000
14503117,44995,SWAP20,6000,,6000,0
14503117,44995,SWAP20,6000,,6000,0
14503117,44995,SWAP20,6000,6,6000,0
14493423,44993,SWAP20,12000,10,10000,2000
14479002,44987,SWAP20,12000,8,8000,4000
14361689,44942,SWAP20,15000,8,8000,7000
14402416,44958,SWAP20,10000,7,7000,3000
14392567,44953,SWAP20,15000,25,25000,-10000
14392567,44953,SWAP20,15000,11,11000,4000
14396135,44956,SWAP20,19000,19,19000,0
14411970,44963,SWAP20,10000,14,14000,-4000
14497468,44994,SWAP20,15000,18,18000,-3000
14457281,44979,SWAP20,11000,13,13000,-2000
14425145,44966,SWAP20,8000,8,8000,0
14475865,44986,SWAP20,15000,16,16000,-1000
14492111,44992,SWAP20,5000,4,4000,1000
14507189,44998,SWAP20,14000,11,11000,3000
14520665,45002,SWAP20,14000,10,10000,4000
14465518,44983,SWAP20,5000,5,5000,0
14534427,45008,SWAP20,5000,5,5000,0
14508327,44998,SWAP20,10000,8,8000,2000
14473424,44985,SWAP20,15000,17,17000,-2000
14526697,45005,SWAP20,3000,16,16000,-13000
14531803,45007,SWAP20,15000,,15000,0
14471569,44985,SWAP20,10000,10,10000,0
14508241,44998,SWAP20,15000,20,20000,-5000
14495011,44993,SWAP20,8000,15,15000,-7000
14411989,44963,SWAP20,12000,10,10000,2000
14517000,45001,SWAP20,15000,15,15000,0
14487929,44991,SWAP20,15000,15,15000,0
14473425,44985,SWAP20,15000,16,16000,-1000
14461509,44980,SWAP20,10000,9,9000,1000
14451478,44977,SWAP20,15000,16,16000,-1000
14491082,44992,SWAP20,14000,15,15000,-1000
14536050,45008,SWAP20,14000,15,15000,-1000
14469734,44984,SWAP20,15000,17,17000,-2000
14483008,44990,SWAP20,12000,11,11000,1000
14525845,45005,SWAP20,10000,10,10000,0
14534430,45008,SWAP20,16000,18,18000,-2000
14510528,44999,SWAP20,12000,12,12000,0
14510528,44999,SWAP20,12000,,12000,0
14513763,45000,SWAP20,16000,15,15000,1000
14510277,44999,SWAP20,8000,9,9000,-1000
14510529,44999,SWAP20,13000,11,11000,2000
14495123,44993,SWAP20,14000,14,14000,0
14491084,44992,SWAP20,10000,16,16000,-6000
14524626,45005,SWAP20,14000,17,17000,-3000
14525847,45005,SWAP20,15000,16,16000,-1000
14406072,44959,UNKNOWN,9000,12,12000,-3000
14408036,44960,SWAP20,8000,8,8000,0
14510472,44999,SWAP20,15000,15,15000,0
14502890,44995,SWAP20,11000,10,10000,1000
14520963,45004,SWAP20,13000,12,12000,1000
14483013,44990,SWAP20,15000,18,18000,-3000
14535258,45008,SWAP20,7000,10,10000,-3000
14478534,44987,SWAP20,7000,10,10000,-3000
14465056,44981,SWAP20,3000,5,5000,-2000
14482770,44988,SWAP20,15000,20,20000,-5000
14353899,44938,SWAP20,8000,6,6000,2000
14507192,44998,SWAP20,15000,18,18000,-3000
14510532,44999,SWAP20,10000,15,15000,-5000
14371769,44945,SWAP20,8000,6,6000,2000
14538171,45009,SWAP20,5000,6,6000,-1000
14399775,44957,FLA20,17000,19,19000,-2000
14408103,44960,SWAP20,12000,15,15000,-3000
14507193,44998,SWAP20,15000,10,10000,5000
14464005,44981,SWAP20,10000,9,9000,1000
14478536,44987,SWAP20,5000,4,4000,1000
14478536,44987,SWAP20,5000,,5000,0
14423128,44966,SWAP20,8000,8,8000,0
14371771,44945,SWAP20,8000,4,4000,4000
14385134,44951,SWAP20,8000,4,4000,4000
14371772,44945,SWAP20,8000,4,4000,4000
14414608,44963,SWAP20,5000,,5000,0
14414608,44963,SWAP20,5000,4,4000,1000
14451275,44977,SWAP20,12000,11,11000,1000
14479041,44987,SWAP20,5000,6,6000,-1000
14506460,44998,SWAP20,12000,9,9000,3000
14517021,45001,SWAP20,14000,11,11000,3000
14414607,44963,SWAP20,5000,,5000,0
14414607,44963,SWAP20,5000,4,4000,1000
14414607,44963,SWAP20,5000,,5000,0
14371807,44945,SWAP20,19000,14,14000,5000
14517003,45001,SWAP20,10000,8,8000,2000
14475866,44986,SWAP20,5000,5,5000,0
14454392,44978,SWAP20,6000,6,6000,0
14487933,44991,SWAP20,7000,8,8000,-1000
14493590,44993,SWAP20,10000,11,11000,-1000
14535464,45008,KTA,30000,17,17000,13000
14532406,45007,KTA,28000,34,34000,-6000
14498275,44994,KTA,19000,19,19000,0
14516957,45001,KTA,30000,21,21000,9000
14516957,45001,KTA,30000,,30000,0
14506898,44998,KTA,30000,22,22000,8000
14506898,44998,KTA,30000,,30000,0
14332442,44929,KTA,36000,23,23000,13000
14356664,44939,KTA,36000,25,25000,11000
14367594,44944,KTA,36000,26,26000,10000
14396051,44956,KTA,41000,24,24000,17000
14411971,44963,KTA,32000,31,31000,1000
14424395,44966,KTA,11000,11,11000,0
14401660,44958,KTA,22000,10,10000,12000
14388828,44952,KTA,34000,26,26000,8000
14382972,44950,KTA,31000,24,24000,7000
14510473,44999,KTA,20000,18,18000,2000
14498395,44994,KTA,28000,27,27000,1000
14487937,44991,KTA,25000,24,24000,1000
14434103,44970,KTA,25000,18,18000,7000
14478544,44987,KTA,28000,26,26000,2000
14502054,44995,KTA,17000,20,20000,-3000
14502054,44995,KTA,17000,,17000,0
14375136,44946,KTA,22000,10,10000,12000
14356667,44939,KTA,41000,29,29000,12000
14353900,44938,KTA,33000,22,22000,11000
14329988,44928,KTA,36000,30,30000,6000
14408039,44960,KTA,17000,19,19000,-2000
14433592,44970,KTA,11000,10,10000,1000
14446094,44974,KTA,11000,9,9000,2000
14421669,44965,KTA,18000,14,14000,4000
14371775,44945,KTA,22000,10,10000,12000
14385136,44951,KTA,41000,19,19000,22000
14352570,44938,KTA,27000,,27000,0
14471576,44985,KTA,17000,19,19000,-2000
14487938,44991,KTA,11000,10,10000,1000
14446222,44974,KTA,22000,18,18000,4000
14453896,44978,KTA,32000,35,35000,-3000
14351014,44937,KTA,22000,10,10000,12000
14361646,44942,KTA,36000,33,33000,3000
14382333,44950,KTA,22000,10,10000,12000
14382333,44950,KTA,22000,,22000,0
14382333,44950,KTA,22000,,22000,0
14382333,44950,KTA,22000,,22000,0
14475803,44986,KTA,20000,15,15000,5000
14468781,44984,KTA,25000,24,24000,1000
14487939,44991,KTA,11000,10,10000,1000
14495012,44993,KTA,17000,15,15000,2000
14513842,45000,KTA,30000,26,26000,4000
14510297,44999,KTA,27000,20,20000,7000
14493981,44993,KTA,17000,23,23000,-6000
14331763,44929,KTA,41000,19,19000,22000
14353932,44938,KTA,31000,11,11000,20000
14379339,44949,KTA,32000,20,20000,12000
14405181,44959,KTA,30000,28,28000,2000
14364668,44943,KTA,26000,11,11000,15000
14339566,44931,KTA,24000,10,10000,14000
14491821,44992,KTA,24000,18,18000,6000
14443243,44973,KTA,26000,17,17000,9000
14425702,44967,KTA,17000,15,15000,2000
14502491,44995,KTA,25000,24,24000,1000
14502491,44995,KTA,25000,,25000,0
14502491,44995,KTA,25000,,25000,0
14347297,44936,KTA,38000,18,18000,20000
14331764,44929,KTA,28000,24,24000,4000
14397035,44956,KTA,33000,24,24000,9000
14408124,44960,KTA,28000,28,28000,0
14491088,44992,KTA,25000,18,18000,7000
14479043,44987,KTA,15000,14,14000,1000
14516951,45001,KTA,20000,12,12000,8000
14529599,45006,KTA,30000,,30000,0
14529599,45006,KTA,30000,34,34000,-4000
14529599,45006,KTA,30000,,30000,0
14516952,45001,KTA,20000,14,14000,6000
14490342,44992,KTA,17000,30,30000,-13000
14433597,44970,KTA,30000,27,27000,3000
14451400,44977,KTA,32000,39,39000,-7000
14475805,44986,KTA,24000,17,17000,7000
14401974,44958,KTA,31000,19,19000,12000
14416853,44964,KTA,35000,30,30000,5000
14392569,44953,KTA,29000,19,19000,10000
14351040,44937,KTA,22000,10,10000,12000
14369910,44944,KTA,41000,28,28000,13000
14385137,44951,KTA,29000,18,18000,11000
14454396,44978,KTA,25000,22,22000,3000
14529548,45006,KTA,30000,26,26000,4000
14529548,45006,KTA,30000,,30000,0
14529548,45006,KTA,30000,,30000,0
14517097,45001,KTA,11000,9,9000,2000
14510461,44999,KTA,26000,,26000,0
14510461,44999,KTA,26000,18,18000,8000
14471577,44985,KTA,25000,19,19000,6000
14464672,44981,KTA,21000,18,18000,3000
14379297,44949,KTA,26000,13,13000,13000
14388231,44952,KTA,22000,10,10000,12000
14423006,44966,KTA,20000,12,12000,8000
14365065,44943,KTA,28100,12,12000,16100
14534802,45008,KTA,18000,,18000,0
14534802,45008,KTA,18000,17,17000,1000
14464673,44981,KTA,18000,18,18000,0
14425721,44967,KTA,18000,9,9000,9000
14425721,44967,KTA,18000,10,10000,8000
14423008,44966,KTA,18000,14,14000,4000
14408155,44960,KTA,11000,10,10000,1000
14392571,44953,KTA,29000,18,18000,11000
14382431,44950,KTA,43000,18,18000,25000
14351690,44937,KTA,24000,,24000,0
14351690,44937,KTA,24000,11,11000,13000
14356669,44939,KTA,41000,28,28000,13000
14520543,45002,KTA,16000,,16000,0
14520543,45002,KTA,16000,16,16000,0
14482958,44988,KTA,25000,19,19000,6000
14493591,44993,KTA,35000,30,30000,5000
14493591,44993,KTA,35000,,35000,0
14493591,44993,KTA,35000,,35000,0
14532231,45007,KTA,11000,11,11000,0
14446667,44974,KTA,28000,25,25000,3000
14468870,44984,KTA,26000,29,29000,-3000
14420441,44965,KTA,11000,9,9000,2000
14502507,44995,KTA,18000,,18000,0
14502507,44995,KTA,18000,12,12000,6000
14510298,44999,KTA,30000,36,36000,-6000
14517004,45001,KTA,25000,19,19000,6000
14517004,45001,KTA,25000,,25000,0
14494439,44993,KTA,11000,13,13000,-2000
14479003,44987,KTA,25000,24,24000,1000
14465310,44981,KTA,25000,,25000,0
14465310,44981,KTA,25000,20,20000,5000
14465310,44981,KTA,25000,20,20000,5000
14351429,44937,KTA,22000,10,10000,12000
14471748,44985,KTA,33000,32,32000,1000
14496896,44994,KTA,25000,25,25000,0
14506526,44998,KTA,25000,15,15000,10000
14483015,44988,KTA,11000,10,10000,1000
14446668,44974,KTA,11000,101,10100,900
14417447,44964,KTA,30000,12,12000,18000
14417447,44964,KTA,30000,12,12000,18000
14436530,44971,KTA,35000,28,28000,7000
14493603,44993,KTA,14000,14,14000,0
14506392,44998,KTA,30000,28,28000,2000
14513844,45000,KTA,20000,14,14000,6000
14509214,44999,SWAP45,18500,25,25000,-6500
14439350,44972,KTA,28000,30,30000,-2000
14461510,44980,KTA,26000,26,26000,0
14353903,44938,KTA,35000,19,19000,16000
14361686,44942,KTA,37000,25,25000,12000
14510534,44999,KTA,36000,28,28000,8000
14528233,45006,KTA,30000,28,28000,2000
14364670,44943,KTA,43000,27,27000,16000
14351049,44937,KTA,25000,14,14000,11000
14332444,44929,KTA,41000,28,28000,13000
14347879,44936,KTA,22000,10,10000,12000
14364671,44943,KTA,36000,21,21000,15000
14416595,44964,KTA,30000,30,30000,0
14382736,44950,KTA,36000,23,23000,13000
14371808,44945,KTA,36000,14,14000,22000
14482777,44988,KTA,11000,13,13000,-2000
14494452,44993,KTA,39000,32,32000,7000
14422402,44966,KTA,22000,27,27000,-5000
14422402,44966,KTA,22000,9,9000,13000
14408180,44960,KTA,11000,13,13000,-2000
14368182,44944,KTA,22000,9,9000,13000
14368182,44944,KTA,22000,9,9000,13000
14347302,44936,KTA,22000,10,10000,12000
14338915,44931,KTA,22000,14,14000,8000
14488181,44991,KTA,15000,18,18000,-3000
14506880,44998,KTA,25000,18,18000,7000
14472532,44985,KTA,26000,18,18000,8000
14475817,44986,KTA,17000,12,12000,5000
14464674,44981,KTA,16000,14,14000,2000
14457641,44979,KTA,31000,27,27000,4000
14426362,44967,KTA,11000,9,9000,2000
14451277,44977,KTA,25000,24,24000,1000
14510170,44999,KTA,30000,22,22000,8000
14482877,44988,KTA,12000,12,12000,0
14338918,44931,KTA,22000,9,9000,13000
14524627,45005,KTA,30000,24,24000,6000
14535264,45008,KTA,31000,,31000,0
14535264,45008,KTA,31000,23,23000,8000
14336563,44930,KTA,35000,20,20000,15000
14347300,44936,KTA,36000,30,30000,6000
14479052,44987,KTA,15000,,15000,0
14454397,44978,KTA,17000,15,15000,2000
14502509,44995,KTA,27000,,27000,0
14502509,44995,KTA,27000,24,24000,3000
14510536,44999,KTA,36000,14,14000,22000
14405948,44959,KTA,17000,15,15000,2000
14419044,44965,KTA,11000,10,10000,1000
14527903,45006,KTA,25000,18,18000,7000
14527903,45006,KTA,25000,,25000,0
14392382,44953,KTA,22000,17,17000,5000
14488308,44991,KTA,25000,24,24000,1000
14464675,44981,KTA,11000,,11000,0
14464675,44981,KTA,11000,,11000,0
14464675,44981,KTA,11000,12,12000,-1000
14475730,44986,KTA,15000,26,26000,-11000
14473224,44985,KTA,11000,10,10000,1000
14492105,44992,KTA,24000,24,24000,0
14392393,44953,KTA,21000,16,16000,5000
14414259,44963,KTA,11000,10,10000,1000
14414259,44963,KTA,11000,10,10000,1000
14356723,44939,KTA,28000,12,12000,16000
14356723,44939,KTA,28000,12,12000,16000
14537478,45009,KTA,28000,20,20000,8000
14344495,44935,KTA,27000,12,12000,15000
14336564,44930,KTA,24000,9,9000,15000
14423010,44966,KTA,11000,,11000,0
14423010,44966,KTA,11000,,11000,0
14423010,44966,KTA,11000,10,10000,1000
14473429,44985,KTA,26000,27,27000,-1000
14453898,44978,KTA,18000,17,17000,1000
14453898,44978,KTA,18000,,18000,0
14439335,44972,KTA,32000,29,29000,3000
14408106,44960,KTA,25000,15,15000,10000
14405205,44959,KTA,28000,25,25000,3000
14411972,44963,KTA,26000,26,26000,0
14531808,45007,KTA,23000,21,21000,2000
14411973,44963,KTA,32000,29,29000,3000
14386118,44951,KTA,22000,10,10000,12000
14375291,44946,KTA,31000,22,22000,9000
14345405,44935,KTA,46000,30,30000,16000
14361681,44942,KTA,34000,18,18000,16000
14464676,44981,KTA,15000,12,12000,3000
14490348,44992,KTA,33000,22,22000,11000
14520486,45002,KTA,28000,31,31000,-3000
14464006,44981,KTA,28000,23,23000,5000
14347306,44936,KTA,28000,16,16000,12000
14412957,44963,KTA,28000,22,22000,6000
14422747,44966,KTA,11000,10,10000,1000
14475647,44986,KTA,26500,15,15000,11500
14510476,44999,KTA,20000,27,27000,-7000
14517099,45001,KTA,11000,9,9000,2000
14475878,44986,KTA,20000,12,12000,8000
14454398,44978,KTA,24000,15,15000,9000
14446643,44974,KTA,11000,9,9000,2000
14352364,44937,KTA,22000,9,9000,13000
14353934,44938,KTA,43000,31,31000,12000
14332446,44929,KTA,22000,9,9000,13000
14433207,44970,KTA,30000,33,33000,-3000
14475819,44986,KTA,35000,31,31000,4000
14468783,44984,KTA,30000,26,26000,4000
14458864,44979,KTA,20000,15,15000,5000
14510309,44999,KTA,20000,14,14000,6000
14482883,44988,KTA,26000,20,20000,6000
14524628,45005,KTA,29000,11,11000,18000
14490759,44992,KTA,11000,8,8000,3000
14496898,44994,KTA,17000,10,10000,7000
14461512,44980,KTA,20000,16,16000,4000
14385140,44951,KTA,36000,22,22000,14000
14330019,44928,KTA,36000,22,22000,14000
14336578,44930,KTA,29000,12,12000,17000
14330414,44928,KTA,36000,32,32000,4000
14446223,44974,KTA,25000,19,19000,6000
14453912,44978,KTA,20000,16,16000,4000
14401981,44958,KTA,27000,23,23000,4000
14408112,44960,KTA,24000,17,17000,7000
14445805,44974,KTA,20000,16,16000,4000
14471579,44985,KTA,15000,14,14000,1000
14464678,44981,KTA,34000,28,28000,6000
14457642,44979,KTA,17000,15,15000,2000
14496899,44994,KTA,27000,25,25000,2000
14520545,45002,KTA,20000,20,20000,0
14402932,44958,KTA,11000,30,30000,-19000
14351037,44937,KTA,31000,18,18000,13000
14367538,44944,KTA,22000,9,9000,13000
14532278,45007,KTA,20000,,20000,0
14532278,45007,KTA,20000,,20000,0
14532278,45007,KTA,20000,12,12000,8000
14525828,45005,KTA,24000,13,13000,11000
14371811,44945,KTA,27000,12,12000,15000
14482698,44988,KTA,11000,10,10000,1000
14482698,44988,KTA,11000,10,10000,1000
14464681,44981,KTA,11000,10,10000,1000
14517100,45001,KTA,11000,,11000,0
14517100,45001,KTA,11000,10,10000,1000
14510492,44999,KTA,20000,14,14000,6000
14345295,44935,KTA,36000,20,20000,16000
14339552,44931,KTA,39000,23,23000,16000
14514125,45000,KTA,25000,23,23000,2000
14497515,44994,KTA,25000,26,26000,-1000
14528493,45006,KTA,23000,21,21000,2000
14502510,44995,KTA,25000,20,20000,5000
14502510,44995,KTA,25000,,25000,0
14516879,45001,KTA,25000,17,17000,8000
14516879,45001,KTA,25000,,25000,0
14468784,44984,KTA,18000,,18000,0
14468784,44984,KTA,18000,12,12000,6000
14461514,44980,KTA,34000,31,31000,3000
14470864,44985,KTA,11000,,11000,0
14470864,44985,KTA,11000,13,13000,-2000
14478548,44987,KTA,19000,10,10000,9000
14478548,44987,KTA,19000,,19000,0
14446227,44974,KTA,27000,27,27000,0
14440045,44972,KTA,11000,9,9000,2000
14364680,44943,KTA,37000,24,24000,13000
14351039,44937,KTA,39000,25,25000,14000
14375300,44946,KTA,36000,19,19000,17000
14473292,44985,KTA,26000,24,24000,2000
14442628,44973,KTA,30000,29,29000,1000
14513848,45000,KTA,35000,30,30000,5000
14502514,44995,KTA,27000,,27000,0
14502514,44995,KTA,27000,24,24000,3000
14502514,44995,KTA,27000,,27000,0
14502514,44995,KTA,27000,18,18000,9000
14418005,44964,KTA,17000,13,13000,4000
14340121,44931,KTA,22000,9,9000,13000
14535267,45008,KTA,22000,20,20000,2000
14331766,44929,KTA,39000,25,25000,14000
14347828,44936,KTA,22000,8,8000,14000
14479006,44987,KTA,23000,12,12000,11000
14443244,44973,KTA,11000,9,9000,2000
14425839,44967,KTA,17000,,17000,0
14460701,44980,KTA,33000,31,31000,2000
14356577,44939,KTA,22000,10,10000,12000
14344496,44935,KTA,33000,18,18000,15000
14399769,44957,KTA,24000,20,20000,4000
14382435,44950,KTA,33000,19,19000,14000
14385612,44951,KTA,22000,,22000,0
14385612,44951,KTA,22000,9,9000,13000
14371812,44945,KTA,45000,34,34000,11000
14396052,44956,KTA,33000,24,24000,9000
14356766,44939,KTA,22000,10,10000,12000
14493606,44993,KTA,17000,11,11000,6000
14493606,44993,KTA,17000,10,10000,7000
14520668,45002,KTA,19000,18,18000,1000
14510538,44999,KTA,35000,25,25000,10000
14510538,44999,KTA,35000,,35000,0
14336318,44930,KTA,22000,9,9000,13000
14416858,44964,KTA,17000,12,12000,5000
14424858,44966,KTA,36000,27,27000,9000
14399031,44957,KTA,22000,10,10000,12000
14399031,44957,KTA,22000,9,9000,13000
14375301,44946,KTA,31000,17,17000,14000
14379340,44949,KTA,27000,13,13000,14000
14332449,44929,KTA,22000,13,13000,9000
14475789,44986,KTA,11000,10,10000,1000
14436877,44971,KTA,20000,17,17000,3000
14433210,44970,KTA,11000,10,10000,1000
14392572,44953,KTA,32000,9,9000,23000
14399218,44957,KTA,46000,29,29000,17000
14411992,44963,KTA,11000,11,11000,0
14389614,44952,KTA,18000,13,13000,5000
14425705,44967,KTA,25000,26,26000,-1000
14439256,44972,KTA,11000,9,9000,2000
14468786,44984,KTA,25000,17,17000,8000
14375309,44946,KTA,26000,12,12000,14000
14382335,44950,KTA,22000,14,14000,8000
14403008,44958,KTA,11000,9,9000,2000
14331135,44928,KTA,31000,19,19000,12000
14364700,44943,KTA,22000,9,9000,13000
14425726,44967,KTA,11000,9,9000,2000
14451089,44977,KTA,20000,22,22000,-2000
14475880,44986,KTA,26000,22,22000,4000
14506393,44998,KTA,15000,,15000,0
14506393,44998,KTA,15000,14,14000,1000
14506393,44998,KTA,15000,15,15000,0
14514130,45000,KTA,28000,27,27000,1000
14492029,44992,KTA,11000,10,10000,1000
14379311,44949,KTA,36000,24,24000,12000
14388832,44952,KTA,39000,26,26000,13000
14357822,44939,KTA,22000,10,10000,12000
14345480,44935,KTA,22000,9,9000,13000
14510478,44999,KTA,15000,15,15000,0
14524274,45005,KTA,25000,18,18000,7000
14479054,44987,KTA,11000,12,12000,-1000
14451698,44977,KTA,11000,9,9000,2000
14426784,44967,KTA,11000,10,10000,1000
14371648,44945,KTA,22000,10,10000,12000
14402970,44958,KTA,16000,16,16000,0
14436533,44971,KTA,23000,19,19000,4000
14532417,45007,KTA,34000,26,26000,8000
14460702,44980,KTA,25000,21,21000,4000
14487184,44991,KTA,25000,18,18000,7000
14487186,44991,KTA,25000,25,25000,0
14517005,45001,KTA,25000,,25000,0
14517005,45001,KTA,25000,16,16000,9000
14471429,44985,KTA,31000,30,30000,1000
14453921,44978,KTA,16000,19,19000,-3000
14398557,44957,KTA,26000,12,12000,14000
14423011,44966,KTA,25000,20,20000,5000
14386394,44951,KTA,22000,9,9000,13000
14442632,44973,KTA,11000,10,10000,1000
14517006,45001,KTA,25000,25,25000,0
14503325,44997,KTA,31000,19,19000,12000
14531811,45007,KTA,23000,18,18000,5000
14433600,44970,KTA,32000,29,29000,3000
14478549,44987,KTA,34000,25,25000,9000
14388835,44952,KTA,22000,10,10000,12000
14398559,44957,KTA,37000,20,20000,17000
14385613,44951,KTA,46000,29,29000,17000
14336571,44930,KTA,37000,24,24000,13000
14510539,44999,KTA,25000,,25000,0
14510539,44999,KTA,25000,28,28000,-3000
14535270,45008,KTA,30000,30,30000,0
14524629,45005,KTA,29000,13,13000,16000
14534435,45008,KTA,11000,10,10000,1000
14491095,44992,KTA,11000,9,9000,2000
14482967,44988,KTA,17000,12,12000,5000
14465536,44983,KTA,23000,25,25000,-2000
14408127,44960,KTA,18000,17,17000,1000
14419504,44965,KTA,11000,10,10000,1000
14409252,44960,KTA,17000,12,12000,5000
14392395,44953,KTA,24000,12,12000,12000
14364597,44943,KTA,22000,10,10000,12000
14475894,44986,KTA,30000,29,29000,1000
14493953,44993,KTA,12000,17,17000,-5000
14513850,45000,KTA,20000,11,11000,9000
14524630,45005,KTA,29000,20,20000,9000
14475763,44986,KTA,17000,15,15000,2000
14368250,44944,KTA,28000,20,20000,8000
14375537,44946,KTA,22000,18,18000,4000
14396140,44956,KTA,38000,24,24000,14000
14416859,44964,KTA,20000,16,16000,4000
14405211,44959,KTA,30000,24,24000,6000
14436771,44971,KTA,23000,17,17000,6000
14520671,45002,KTA,29000,17,17000,12000
14520671,45002,KTA,29000,,29000,0
14330022,44928,KTA,33000,17,17000,16000
14380076,44949,KTA,41000,29,29000,12000
14513791,45000,KTA,11000,11,11000,0
14513791,45000,KTA,11000,,11000,0
14491006,44992,KTA,11000,,11000,0
14491006,44992,KTA,11000,,11000,0
14491006,44992,KTA,11000,10,10000,1000
14468897,44984,KTA,30000,27,27000,3000
14461515,44980,KTA,27000,27,27000,0
14426364,44967,KTA,11000,15,15000,-4000
14419055,44965,KTA,35000,24,24000,11000
14357876,44939,KTA,40000,28,28000,12000
14513851,45000,KTA,35000,36,36000,-1000
14531816,45007,KTA,34000,37,37000,-3000
14535272,45008,TRA,24000,29,29000,-5000
14521186,45002,TRA,7000,10,10000,-3000
14521186,45002,TRA,7000,,7000,0
14510479,44999,KTA,33000,34,34000,-1000
14475897,44986,KTA,13000,14,14000,-1000
14514089,45000,KTA,27000,19,19000,8000
14502515,44995,KTA,27000,27,27000,0
14502515,44995,KTA,27000,,27000,0
14482969,44988,KTA,27000,18,18000,9000
14508658,44998,KTA,29000,29,29000,0
14525850,45005,KTA,23000,23,23000,0
14520583,45002,KTA,28000,27,27000,1000
14510482,44999,KTA,35000,32,32000,3000
14408136,44960,KTA,28000,24,24000,4000
14385614,44951,KTA,38000,30,30000,8000
14396053,44956,KTA,37000,19,19000,18000
14520588,45002,TRA,16000,27,27000,-11000
14495124,44993,TRA,33000,33,33000,0
14479008,44987,KTA,30000,33,33000,-3000
14513852,45000,KTA,22000,27,27000,-5000
14468789,44984,KTA,23000,23,23000,0
14446228,44974,KTA,11000,16,16000,-5000
14520590,45002,KTA,32000,32,32000,0
14371776,44945,KTA,29000,20,20000,9000
14336572,44930,KTA,22000,11,11000,11000
14527905,45006,KTA,29000,25,25000,4000
14531837,45007,KTA,24000,23,23000,1000
14345403,44935,KTA,34000,24,24000,10000
14353935,44938,KTA,26000,16,16000,10000
14487378,44991,KTA,23000,18,18000,5000
14438735,44972,KTA,27000,27,27000,0
14388836,44952,KTA,43000,30,30000,13000
14405214,44959,KTA,16000,14,14000,2000
14419057,44965,KTA,15000,11,11000,4000
14361680,44942,KTA,36000,29,29000,7000
14339554,44931,KTA,36000,,36000,0
14339554,44931,KTA,36000,25,25000,11000
14453935,44978,KTA,24000,18,18000,6000
14496901,44994,KTA,35000,36,36000,-1000
14494914,44993,KTA,15000,15,15000,0
14358082,44939,KTA,35000,18,18000,17000
14524633,45005,KTA,30000,,30000,0
14524633,45005,KTA,30000,30,30000,0
14356672,44939,KTA,26000,15,15000,11000
14497603,44994,KTA,30000,30,30000,0
14419058,44965,KTA,20000,32,32000,-12000
14483016,44990,KTA,30000,28,28000,2000
14469737,44984,KTA,31000,34,34000,-3000
14479055,44987,KTA,27000,27,27000,0
14488182,44991,KTA,28000,26,26000,2000
14502900,44997,KTA,32000,32,32000,0
14471607,44985,KTA,30000,26,26000,4000
14442635,44973,KTA,32000,26,26000,6000
14425707,44967,KTA,32000,24,24000,8000
14418286,44964,KTA,26000,29,29000,-3000
14392574,44953,KTA,31000,25,25000,6000
14371813,44945,KTA,22000,12,12000,10000
14382437,44950,KTA,43000,29,29000,14000
14364685,44943,KTA,44000,31,31000,13000
14513766,45000,KTA,22000,31,31000,-9000
14520488,45002,TRA,14000,,14000,0
14520488,45002,TRA,14000,,14000,0
14520488,45002,TRA,14000,14,14000,0
14506395,44998,TRA,26000,28,28000,-2000
14425139,44966,TRA,16000,24,24000,-8000
14454399,44978,TRA,24000,26,26000,-2000
14471733,44985,TRA,22000,25,25000,-3000
14456545,44979,TRA,24000,25,25000,-1000
14468791,44984,KTA,22000,20,20000,2000
14451482,44977,KTA,30000,30,30000,0
14502905,44995,KTA,26000,22,22000,4000
14516953,45001,KTA,28000,26,26000,2000
14396141,44956,KTA,36000,24,24000,12000
14535275,45008,KTA,11000,13,13000,-2000
14482973,44988,KTA,27000,30,30000,-3000
14520965,45004,KTA,34000,34,34000,0
14367808,44944,KTA,31000,169,16900,14100
14538190,45009,KTA,22000,23,23000,-1000
14498039,44994,KTA,33000,33,33000,0
14465144,44981,KTA,11000,10,10000,1000
14507197,44998,KTA,29000,17,17000,12000
14487379,44991,KTA,25000,25,25000,0
14461518,44980,KTA,23000,,23000,0
14461518,44980,KTA,23000,22,22000,1000
14446646,44974,KTA,25000,16,16000,9000
14436059,44971,KTA,31000,30,30000,1000
14397068,44956,KTA,38000,27,27000,11000
14405219,44959,KTA,17000,15,15000,2000
14371814,44945,KTA,43000,30,30000,13000
14353905,44938,KTA,41000,28,28000,13000
14345402,44935,KTA,34000,18,18000,16000
14451702,44977,KTA,25000,21,21000,4000
14475654,44986,KTA,27000,22,22000,5000
14510484,44999,KTA,20000,14,14000,6000
14534436,45008,KTA,25000,26,26000,-1000
14458845,44979,KTA,15000,199,19900,-4900
14452875,44977,KTA,41000,27,27000,14000
14514132,45000,KTA,29000,25,25000,4000
14514132,45000,KTA,29000,,29000,0
14528124,45006,KTA,11000,11,11000,0
14483018,44988,KTA,15000,20,20000,-5000
14488187,44991,KTA,11000,11,11000,0
14529292,45006,KTA,11000,11,11000,0
14534437,45008,TRA,21000,28,28000,-7000
14480092,44987,KTA,25000,21,21000,4000
14465521,44983,KTA,34000,30,30000,4000
14469738,44984,KTA,25000,,25000,0
14469738,44984,KTA,25000,18,18000,7000
14509860,44999,KTA,36000,34,34000,2000
14442636,44973,KTA,30000,24,24000,6000
14331767,44929,KTA,39000,25,25000,14000
14351041,44937,KTA,39000,25,25000,14000
14371815,44945,KTA,35000,23,23000,12000
14388395,44952,KTA,22000,12,12000,10000
14399220,44957,KTA,36000,22,22000,14000
14417475,44964,KTA,25000,26,26000,-1000
14528236,45006,KTA,25000,29,29000,-4000
14473365,44985,KTA,29000,22,22000,7000
14492113,44992,KTA,11000,10,10000,1000
14516955,45001,KTA,33000,32,32000,1000
14347301,44936,KTA,31000,16,16000,15000
14488202,44991,KTA,30000,33,33000,-3000
14532424,45007,KTA,25000,21,21000,4000
14337570,44930,KTA,29000,18,18000,11000
14479011,44987,KTA,35000,26,26000,9000
14498331,44994,KTA,28000,26,26000,2000
14514133,45000,KTA,33000,,33000,0
14411980,44963,KTA,29000,28,28000,1000
14424917,44966,KTA,34000,31,31000,3000
14528125,45006,KTA,11000,11,11000,0
14510310,44999,KTA,28000,29,29000,-1000
14464021,44981,KTA,20000,,20000,0
14464021,44981,KTA,20000,26,26000,-6000
14408152,44960,KTA,16000,12,12000,4000
14347464,44936,KTA,41000,23,23000,18000
14465124,44981,KTA,11000,11,11000,0
14493426,44993,KTA,27000,24,24000,3000
14491098,44992,KTA,26000,25,25000,1000
14469740,44984,KTA,29000,19,19000,10000
14473432,44985,KTA,34000,33,33000,1000
14509865,44999,KTA,34000,33,33000,1000
14525852,45005,KTA,32000,32,32000,0
14507198,44998,KTA,32000,32,32000,0
14520673,45004,KTA,24000,24,24000,0
14361678,44942,KTA,38000,27,27000,11000
14517007,45001,KTA,22000,21,21000,1000
14457649,44979,KTA,11000,12,12000,-1000
14433603,44970,KTA,25000,22,22000,3000
14514140,45000,KTA,30000,30,30000,0
14495139,44993,KTA,31000,31,31000,0
14517008,45001,KTA,27000,26,26000,1000
14347467,44936,KTA,31000,18,18000,13000
14330814,44928,KTA,36000,32,32000,4000
14493427,44993,KTA,27000,21,21000,6000
14479059,44987,KTA,11000,11,11000,0
14517009,45001,KTA,11000,11,11000,0
14517009,45001,KTA,11000,11,11000,0
14469741,44984,KTA,33000,34,34000,-1000
14493610,44993,KTA,12000,12,12000,0
14524634,45005,KTA,30000,24,24000,6000
14534438,45008,KTA,30000,30,30000,0
14502519,44995,KTA,20000,20,20000,0
14502519,44995,KTA,20000,,20000,0
14367858,44944,KTA,36000,26,26000,10000
14356673,44939,KTA,28000,15,15000,13000
14402971,44958,KTA,17000,15,15000,2000
14380075,44949,KTA,38000,25,25000,13000
14361648,44942,KTA,36000,22,22000,14000
14364688,44943,KTA,28000,12,12000,16000
14330025,44928,KTA,36000,30,30000,6000
14339558,44931,KTA,35000,22,22000,13000
14385141,44951,KTA,26000,14,14000,12000
14375533,44946,KTA,41000,26,26000,15000
14475899,44986,KTA,33000,31,31000,2000
14457654,44979,KTA,35000,32,32000,3000
14464023,44981,KTA,16000,12,12000,4000
14464023,44981,KTA,16000,,16000,0
14451279,44977,KTA,25000,21,21000,4000
14479061,44987,KTA,29000,28,28000,1000
14392577,44953,KTA,32000,25,25000,7000
14398882,44957,KTA,33000,17,17000,16000
14496922,44994,KTA,28000,28,28000,0
14520602,45002,KTA,25000,18,18000,7000
14537421,45009,KTA,18000,,18000,0
14529159,45006,KTA,11000,9,9000,2000
14507944,44998,KTA,11000,10,10000,1000
14493611,44993,KTA,14000,14,14000,0
14367335,44944,KTA,29000,17,17000,12000
14502913,44995,KTA,32000,35,35000,-3000
14502913,44995,KTA,32000,,32000,0
14465537,44983,KTA,22000,19,19000,3000
14520641,45002,KTA,11000,9,9000,2000
14520641,45002,KTA,11000,,11000,0
14520641,45002,KTA,11000,,11000,0
14402973,44958,KTA,17000,13,13000,4000
14383190,44950,KTA,41000,22,22000,19000
14532286,45007,KTA,25000,18,18000,7000
14532286,45007,KTA,25000,,25000,0
14532286,45007,KTA,25000,20,20000,5000
14353906,44938,KTA,28000,16,16000,12000
14490351,44992,KTA,27000,20,20000,7000
14469447,44984,KTA,34000,34,34000,0
14398560,44957,KTA,34000,16,16000,18000
14416597,44964,KTA,18000,16,16000,2000
14386422,44951,KTA,41000,10,10000,31000
14528238,45006,KTA,20000,19,19000,1000
14388546,44952,KTA,28000,12,12000,16000
14382445,44950,KTA,28000,10,10000,18000
14362292,44942,KTA,32000,14,14000,18000
14345400,44935,KTA,33000,14,14000,19000
14339559,44931,KTA,22000,9,9000,13000
14361649,44942,KTA,37000,25,25000,12000
14347881,44936,KTA,22000,9,9000,13000
14375823,44946,KTA,22000,9,9000,13000
14487831,44991,KTA,11000,,11000,0
14487831,44991,KTA,11000,9,9000,2000
14483022,44988,KTA,11000,9,9000,2000
14516318,45001,KTA,34000,30,30000,4000
14506906,44998,KTA,35000,,35000,0
14506906,44998,KTA,35000,32,32000,3000
14508552,44998,KTA,36000,32,32000,4000
14469742,44984,KTA,28000,28,28000,0
14333212,44930,KTA,22000,8,8000,14000
14529527,45006,KTA,11000,9,9000,2000
14506480,44998,KTA,30000,32,32000,-2000
14513854,45000,KTA,27000,16,16000,11000
14482974,44988,KTA,11000,9,9000,2000
14491104,44992,KTA,11000,9,9000,2000
14483031,44988,KTA,26000,18,18000,8000
14520649,45002,KTA,11000,,11000,0
14520649,45002,KTA,11000,10,10000,1000
14503185,44995,KTA,11000,9,9000,2000
14443246,44973,KTA,11000,8,8000,3000
14433240,44970,KTA,15000,11,11000,4000
14386396,44951,KTA,22000,8,8000,14000
14419061,44965,KTA,11000,8,8000,3000
14398561,44957,KTA,26000,22,22000,4000
14405164,44959,KTA,18000,9,9000,9000
14364065,44943,KTA,28000,15,15000,13000
14425846,44967,KTA,32000,11,11000,21000
14436773,44971,KTA,32000,25,25000,7000
14442648,44973,KTA,11000,8,8000,3000
14469743,44984,KTA,25000,16,16000,9000
14497705,44994,KTA,15000,,15000,0
14497705,44994,KTA,15000,10,10000,5000
14528242,45006,KTA,25000,19,19000,6000
14525407,45005,KTA,30000,,30000,0
14525407,45005,KTA,30000,,30000,0
14525407,45005,KTA,30000,27,27000,3000
14488310,44991,KTA,20000,17,17000,3000
14405898,44959,KTA,22000,11,11000,11000
14376048,44946,KTA,41000,19,19000,22000
14376048,44946,KTA,41000,,41000,0
14507260,44998,UNKNOWN,16000,16,16000,0
14503264,44995,KTA,11000,6,6000,5000
14514891,45000,KTA,15000,7,7000,8000
14439993,44972,KTA,21000,10,10000,11000
14509875,44999,TRA,14000,10,10000,4000
14488218,44991,TRA,16000,13,13000,3000
14372715,44945,TRA,22000,10,10000,12000
14525853,45005,TRA,26000,,26000,0
14525853,45005,TRA,26000,24,24000,2000
14487957,44991,TRA,24000,18,18000,6000
14507201,44998,TRA,26000,12,12000,14000
14507201,44998,TRA,26000,17,17000,9000
14473423,44985,TRA,23000,19,19000,4000
14531840,45007,TRA,23000,23,23000,0
14336286,44930,TRA,18000,7,7000,11000
14483302,44988,TRA,7000,8,8000,-1000
14479012,44987,TRA,25000,15,15000,10000
14337526,44930,TRA,18000,7,7000,11000
14376175,44946,TRA,22000,11,11000,11000
14532838,45007,TRA,7000,7,7000,0
14532838,45007,TRA,7000,,7000,0
14537424,45009,TRA,11000,,11000,0
14531843,45007,TRA,11000,11,11000,0
14532260,45007,TRA,7000,,7000,0
14532260,45007,TRA,7000,,7000,0
14537426,45009,TRA,11000,,11000,0
14525398,45005,TRA,15000,10,10000,5000
14376088,44946,TRA,18000,7,7000,11000
14353936,44938,TRA,18000,7,7000,11000
14353936,44938,TRA,18000,,18000,0
14440294,44972,TRA,11000,7,7000,4000
14350078,44937,TRA,18000,11,11000,7000
14337506,44930,TRA,18000,6,6000,12000
14419748,44965,TRA,11000,7,7000,4000
14351054,44937,TRA,18000,7,7000,11000
14367356,44944,TRA,25000,,25000,0
14367356,44944,TRA,25000,8,8000,17000
14478550,44987,TRA,12000,12,12000,0
14460703,44980,TRA,17000,11,11000,6000
14524276,45005,TRA,20000,11,11000,9000
14537428,45009,TRA,26000,,26000,0
14506165,44998,TRA,26000,32,32000,-6000
14496878,44994,TRA,17000,,17000,0
14496878,44994,TRA,17000,21,21000,-4000
14457284,44979,TRA,13000,10,10000,3000
14475821,44986,TRA,11000,8,8000,3000
14432816,44970,TRA,11000,7,7000,4000
14353938,44938,TRA,18000,8,8000,10000
14337467,44930,TRA,18000,7,7000,11000
14337467,44930,TRA,18000,,18000,0
14408182,44960,TRA,11000,7,7000,4000
14535991,45008,TRA,14000,9,9000,5000
14528245,45006,TRA,25000,23,23000,2000
14379315,44949,TRA,32000,16,16000,16000
14386120,44951,TRA,18000,7,7000,11000
14392549,44953,TRA,11000,7,7000,4000
14339570,44931,TRA,24000,13,13000,11000
14331792,44929,TRA,23000,10,10000,13000
14364066,44943,TRA,18000,7,7000,11000
14436535,44971,TRA,16000,16,16000,0
14507242,44998,TRA,12000,12,12000,0
14482976,44988,KTA,24000,19,19000,5000
14513855,45000,TRA,17000,10,10000,7000
14531522,45007,TRA,15000,15,15000,0
14440328,44972,TRA,7000,7,7000,0
14392551,44953,TRA,11000,7,7000,4000
14385616,44951,TRA,18000,7,7000,11000
14380066,44949,TRA,18000,6,6000,12000
14380066,44949,TRA,18000,,18000,0
14502917,44995,TRA,28000,23,23000,5000
14434107,44970,TRA,30000,24,24000,6000
14451447,44977,TRA,7000,7,7000,0
14468902,44984,TRA,26000,7,7000,19000
14461521,44980,TRA,13000,10,10000,3000
14402978,44958,TRA,18000,20,20000,-2000
14457285,44979,TRA,13000,7,7000,6000
14438739,44972,TRA,13000,6,6000,7000
14465538,44983,TRA,22000,19,19000,3000
14517010,45001,TRA,25000,15,15000,10000
14479013,44987,TRA,25000,13,13000,12000
14498026,44994,TRA,25000,25,25000,0
14534439,45008,TRA,23000,,23000,0
14534439,45008,TRA,23000,20,20000,3000
14506175,44998,TRA,15000,12,12000,3000
14475900,44986,TRA,14000,10,10000,4000
14491045,44992,TRA,29000,25,25000,4000
14529205,45006,TRA,27000,25,25000,2000
14534440,45008,TRA,20000,13,13000,7000
14495104,44993,TRA,22000,17,17000,5000
14514143,45000,TRA,10000,8,8000,2000
14475779,44986,TRA,27000,,27000,0
14475779,44986,TRA,27000,17,17000,10000
14520675,45004,TRA,20000,20,20000,0
14502967,44997,TRA,24000,17,17000,7000
14483036,44990,TRA,21000,15,15000,6000
14483037,44990,TRA,21000,16,16000,5000
14502969,44997,TRA,24000,12,12000,12000
14525854,45005,TRA,15000,15,15000,0
14528131,45006,TRA,13000,10,10000,3000
14508446,44998,TRA,15000,15,15000,0
14488230,44991,TRA,26000,15,15000,11000
14491314,44992,TRA,20000,18,18000,2000
14506180,44998,TRA,25000,30,30000,-5000
14525855,45005,TRA,15000,10,10000,5000
14491973,44992,TRA,12000,10,10000,2000
14469744,44984,TRA,16000,14,14000,2000
14382336,44950,TRA,33000,22,22000,11000
14510171,44999,SWAP20,15000,8,8000,7000
14535277,45008,SWAP20,15000,,15000,0
14529542,45006,SWAP20,15000,,15000,0
14529542,45006,SWAP20,15000,17,17000,-2000
14529542,45006,SWAP20,15000,,15000,0
14498451,44994,SWAP20,12000,12,12000,0
14478551,44987,SWAP20,15000,16,16000,-1000
14531854,45007,SWAP20,13000,10,10000,3000
14498079,44994,SWAP20,6000,6,6000,0
14520608,45002,SWAP20,12000,,12000,0
14520608,45002,SWAP20,12000,15,15000,-3000
14358137,44939,SWAP20,8000,8,8000,0
14361677,44942,SWAP20,17000,14,14000,3000
14351044,44937,SWAP20,9000,5,5000,4000
14516651,45001,SWAP20,5000,4,4000,1000
14516651,45001,SWAP20,5000,,5000,0
14471611,44985,SWAP20,4000,4,4000,0
14351046,44937,SWAP20,9000,6,6000,3000
14356578,44939,SWAP20,10000,7,7000,3000
14371818,44945,SWAP20,15000,12,12000,3000
14392579,44953,SWAP20,17000,15,15000,2000
14401995,44958,SWAP20,11000,8,8000,3000
14424388,44966,SWAP20,12000,11,11000,1000
14411982,44963,SWAP20,15000,16,16000,-1000
14516313,45001,SWAP20,17000,16,16000,1000
14508682,44998,SWAP20,16000,,16000,0
14508682,44998,SWAP20,16000,16,16000,0
14529208,45006,SWAP20,5000,4,4000,1000
14529208,45006,SWAP20,5000,,5000,0
14529208,45006,SWAP20,5000,,5000,0
14514066,45000,SWAP20,17000,17,17000,0
14520521,45002,SWAP20,9000,7,7000,2000
14425709,44967,SWAP20,5000,16,16000,-11000
14416863,44964,SWAP20,8000,10,10000,-2000
14411983,44963,SWAP20,15000,10,10000,5000
14419937,44965,SWAP20,15000,5,5000,10000
14386398,44951,SWAP20,17000,13,13000,4000
14438755,44972,SWAP20,5600,4,4000,1600
14517012,45001,SWAP20,5000,4,4000,1000
14517012,45001,SWAP20,5000,,5000,0
14434108,44970,SWAP20,17000,17,17000,0
14413127,44963,SWAP20,5000,4,4000,1000
14344498,44935,SWAP20,15000,9,9000,6000
14416390,44964,SWAP20,5000,4,4000,1000
14433742,44970,SWAP20,5000,5,5000,0
14475657,44986,SWAP20,3000,5,5000,-2000
14425727,44967,SWAP20,3000,4,4000,-1000
14443251,44973,SWAP20,10000,10,10000,0
14516654,45001,SWAP20,11000,9,9000,2000
14501244,44995,SWAP20,10000,11,11000,-1000
14501244,44995,SWAP20,10000,,10000,0
14413131,44963,SWAP20,5000,4,4000,1000
14371819,44945,SWAP20,13000,6,6000,7000
14520651,45002,SWAP20,5000,5,5000,0
14520651,45002,SWAP20,5000,,5000,0
14535796,45008,SWAP20,7000,7,7000,0
14411984,44963,SWAP20,9000,8,8000,1000
14405854,44959,SWAP20,8000,5,5000,3000
14392553,44953,SWAP20,8000,4,4000,4000
14408938,44960,SWAP20,5000,5,5000,0
14375462,44946,SWAP20,10000,5,5000,5000
14520409,45002,SWAP20,10000,10,10000,0
14510321,44999,SWAP20,10000,5,5000,5000
14476538,44986,SWAP20,14000,16,16000,-2000
14479016,44987,SWAP20,8000,5,5000,3000
14398563,44957,SWAP20,9000,5,5000,4000
14337465,44930,SWAP20,8000,,8000,0
14337465,44930,SWAP20,8000,4,4000,4000
14462672,44980,SWAP20,10000,12,12000,-2000
14445807,44974,SWAP20,5000,4,4000,1000
14439175,44972,SWAP20,7000,7,7000,0
14418002,44964,SWAP20,7000,7,7000,0
14446648,44974,SWAP20,12000,12,12000,0
14482978,44988,SWAP20,7000,7,7000,0
14491106,44992,SWAP20,7000,7,7000,0
14510541,44999,SWAP20,15000,17,17000,-2000
14524278,45005,SWAP20,15000,,15000,0
14524278,45005,SWAP20,15000,8,8000,7000
14524278,45005,SWAP20,15000,,15000,0
14514863,45000,SWAP20,9000,7,7000,2000
14405165,44959,SWAP20,12000,10,10000,2000
14386053,44951,SWAP20,8000,5,5000,3000
14379317,44949,SWAP20,15000,11,11000,4000
14405344,44959,SWAP20,5000,5,5000,0
14422412,44966,SWAP20,5000,5,5000,0
14347316,44936,SWAP20,10000,10,10000,0
14503060,44995,SWAP20,12000,,12000,0
14503060,44995,SWAP20,12000,12,12000,0
14483040,44988,SWAP20,13000,10,10000,3000
14439176,44972,SWAP20,5000,5,5000,0
14454400,44978,SWAP20,14000,15,15000,-1000
14460704,44980,SWAP20,11000,12,12000,-1000
14460704,44980,SWAP20,11000,11,11000,0
14353939,44938,SWAP20,10000,5,5000,5000
14369808,44944,SWAP20,8000,5,5000,3000
14382978,44950,SWAP20,13000,9,9000,4000
14463898,44981,SWAP20,3000,4,4000,-1000
14463898,44981,SWAP20,3000,,3000,0
14472428,44985,SWAP20,14000,13,13000,1000
14453936,44978,SWAP20,5000,10,10000,-5000
14365568,44943,SWAP20,9000,7,7000,2000
14355378,44938,SWAP20,13000,9,9000,4000
14509879,44999,SWAP20,11000,11,11000,0
14538196,45009,SWAP20,9000,7,7000,2000
14419045,44965,SWAP20,5000,12,12000,-7000
14405856,44959,SWAP20,9000,5,5000,4000
14380349,44949,SWAP20,14000,9,9000,5000
14367915,44944,SWAP20,13000,7,7000,6000
14446255,44974,SWAP20,7000,7,7000,0
14451105,44977,SWAP20,8000,6,6000,2000
14490357,44992,SWAP20,15000,18,18000,-3000
14364071,44943,SWAP20,10000,10,10000,0
14364707,44943,SWAP20,11000,8,8000,3000
14520532,45002,SWAP20,12000,17,17000,-5000
14537483,45009,SWAP20,12000,14,14000,-2000
14367357,44944,SWAP20,8000,4,4000,4000
14331793,44929,SWAP20,15000,14,14000,1000
14368296,44944,SWAP20,8000,4,4000,4000
14361676,44942,SWAP20,15000,12,12000,3000
14382237,44950,SWAP20,8000,,8000,0
14382237,44950,SWAP20,8000,,8000,0
14382237,44950,SWAP20,8000,4,4000,4000
14491194,44992,SWAP20,12000,16,16000,-4000
14439164,44972,SWAP20,5000,4,4000,1000
14439164,44972,SWAP20,5000,,5000,0
14469444,44984,SWAP20,13000,14,14000,-1000
14472432,44985,SWAP20,15000,14,14000,1000
14439603,44972,SWAP20,5000,5,5000,0
14493428,44993,SWAP20,5000,5,5000,0
14487381,44991,SWAP20,11000,16,16000,-5000
14510324,44999,SWAP20,10000,10,10000,0
14373409,44945,SWAP20,10000,6,6000,4000
14356579,44939,SWAP20,8000,5,5000,3000
14535279,45008,SWAP20,14000,10,10000,4000
14524636,45005,SWAP20,8000,8,8000,0
14379341,44949,SWAP20,22000,17,17000,5000
14405230,44959,SWAP20,5000,5,5000,0
14398954,44957,SWAP20,14000,7,7000,7000
14419068,44965,SWAP20,8000,15,15000,-7000
14411987,44963,SWAP20,10000,16,16000,-6000
14510326,44999,SWAP20,10000,10,10000,0
14493970,44993,SWAP20,12000,15,15000,-3000
14473287,44985,SWAP20,5000,10,10000,-5000
14471441,44985,SWAP20,5000,5,5000,0
14461527,44980,SWAP20,7000,7,7000,0
14379319,44949,SWAP20,10000,6,6000,4000
14356676,44939,SWAP20,11000,10,10000,1000
14365466,44943,SWAP20,10000,10,10000,0
14468936,44984,SWAP20,9000,9,9000,0
14488249,44991,SWAP20,9000,9,9000,0
14514144,45000,SWAP20,9000,7,7000,2000
14516958,45001,SWAP20,10000,4,4000,6000
14464689,44981,SWAP20,15000,18,18000,-3000
14457656,44979,SWAP20,10000,10,10000,0
14392587,44953,SWAP20,13000,7,7000,6000
14411996,44963,SWAP20,8000,9,9000,-1000
14399235,44957,SWAP20,18000,10,10000,8000
14528251,45006,SWAP20,8000,9,9000,-1000
14405166,44959,SWAP20,8000,8,8000,0
14419046,44965,SWAP20,5000,5,5000,0
14419046,44965,SWAP20,5000,5,5000,0
14388137,44952,SWAP20,8000,4,4000,4000
14514146,45000,SWAP20,9000,7,7000,2000
14479018,44987,SWAP20,8000,7,7000,1000
14375528,44946,SWAP20,18000,10,10000,8000
14385145,44951,SWAP20,18000,7,7000,11000
14413181,44963,SWAP20,5000,4,4000,1000
14416599,44964,SWAP20,7000,9,9000,-2000
14465515,44983,SWAP20,9000,7,7000,2000
14432805,44970,SWAP20,5000,4,4000,1000
14408085,44960,SWAP20,5000,5,5000,0
14371778,44945,SWAP20,8000,4,4000,4000
14392590,44953,SWAP20,13000,6,6000,7000
14351048,44937,SWAP20,9000,6,6000,3000
14330027,44928,SWAP20,15000,11,11000,4000
14337543,44930,SWAP20,8000,4,4000,4000
14337544,44930,SWAP20,10000,9,9000,1000
14382238,44950,SWAP20,8000,4,4000,4000
14382238,44950,SWAP20,8000,,8000,0
14382238,44950,SWAP20,8000,,8000,0
14382238,44950,SWAP20,8000,,8000,0
14408121,44960,SWAP20,14000,13,13000,1000
14402701,44958,SWAP20,9000,5,5000,4000
14491212,44992,SWAP20,12000,5,5000,7000
14508659,44998,SWAP20,15000,16,16000,-1000
14492032,44992,SWAP20,10000,9,9000,1000
14475906,44986,SWAP20,13000,,13000,0
14475906,44986,SWAP20,13000,9,9000,4000
14528137,45006,SWAP20,9000,6,6000,3000
14475659,44986,SWAP20,8000,7,7000,1000
14475826,44986,SWAP20,16000,16,16000,0
14439624,44972,SWAP20,5000,4,4000,1000
14488405,44991,SWAP20,12000,16,16000,-4000
14514091,45000,SWAP20,6000,6,6000,0
14408945,44960,SWAP20,5000,5,5000,0
14422404,44966,SWAP20,8000,,8000,0
14422404,44966,SWAP20,8000,4,4000,4000
14379669,44949,SWAP20,14000,7,7000,7000
14396057,44956,SWAP20,15000,15,15000,0
14389424,44952,SWAP20,9000,4,4000,5000
14331771,44929,SWAP20,9000,5,5000,4000
14367917,44944,SWAP20,15000,15,15000,0
14347307,44936,SWAP20,13000,9,9000,4000
14398571,44957,SWAP20,15000,15,15000,0
14514093,45000,SWAP20,10000,12,12000,-2000
14503056,44995,SWAP20,12000,13,13000,-1000
14503056,44995,SWAP20,12000,,12000,0
14433605,44970,SWAP20,10000,12,12000,-2000
14425710,44967,SWAP20,13000,12,12000,1000
14412985,44963,SWAP20,8000,6,6000,2000
14345408,44935,SWAP20,3000,7,7000,-4000
14337417,44930,SWAP20,8000,7,7000,1000
14353941,44938,SWAP20,15000,11,11000,4000
14331773,44929,SWAP20,13000,11,11000,2000
14368010,44944,SWAP20,18000,14,14000,4000
14408126,44960,SWAP20,14000,12,12000,2000
14471750,44985,SWAP20,15000,16,16000,-1000
14526794,45005,SWAP20,12000,9,9000,3000
14530189,45007,SWAP20,17000,8,8000,9000
14475905,44986,SWAP20,12000,5,5000,7000
14426797,44967,SWAP20,7000,7,7000,0
14446238,44974,SWAP20,11000,12,12000,-1000
14520614,45002,SWAP20,15000,16,16000,-1000
14487386,44991,SWAP20,12000,6,6000,6000
14479063,44987,SWAP20,10000,6,6000,4000
14439604,44972,SWAP20,15000,12,12000,3000
14471736,44985,SWAP20,4000,5,5000,-1000
14464693,44981,SWAP20,7000,6,6000,1000
14422403,44966,SWAP20,8000,4,4000,4000
14422403,44966,SWAP20,8000,,8000,0
14392400,44953,SWAP20,9000,5,5000,4000
14437978,44971,SWAP20,11000,9,9000,2000
14453937,44978,SWAP20,15000,14,14000,1000
14493429,44993,SWAP20,7000,7,7000,0
14516960,45001,SWAP20,9000,7,7000,2000
14371825,44945,SWAP20,18000,11,11000,7000
14356680,44939,SWAP20,13000,9,9000,4000
14388841,44952,SWAP20,9000,5,5000,4000
14401659,44958,SWAP20,8000,4,4000,4000
14479064,44987,SWAP20,7000,7,7000,0
14487188,44991,SWAP20,12000,6,6000,6000
14531520,45007,SWAP20,13000,16,16000,-3000
14419047,44965,SWAP20,5000,5,5000,0
14330028,44928,SWAP20,13000,11,11000,2000
14491216,44992,SWAP20,12000,6,6000,6000
14510542,44999,SWAP20,10000,10,10000,0
14476963,44986,SWAP20,5000,14,14000,-9000
14532259,45007,SWAP20,5000,,5000,0
14532259,45007,SWAP20,5000,,5000,0
14535284,45008,SWAP20,11000,11,11000,0
14524643,45005,SWAP20,7000,5,5000,2000
14475470,44986,SWAP20,3000,3,3000,0
14439179,44972,SWAP20,10000,13,13000,-3000
14517030,45001,SWAP20,6000,,6000,0
14517030,45001,SWAP20,6000,4,4000,2000
14491220,44992,SWAP20,15000,13,13000,2000
14419048,44965,SWAP20,5000,3,3000,2000
14396143,44956,SWAP20,8000,,8000,0
14396143,44956,SWAP20,8000,,8000,0
14396143,44956,SWAP20,8000,4,4000,4000
14379342,44949,SWAP20,14000,12,12000,2000
14491109,44992,SWAP20,16000,17,17000,-1000
14479068,44987,SWAP20,8000,4,4000,4000
14506398,44998,SWAP20,10000,5,5000,5000
14451282,44977,SWAP20,10000,6,6000,4000
14457657,44979,SWAP20,5000,5,5000,0
14469747,44984,SWAP20,12000,12,12000,0
14506184,44998,SWAP20,15000,12,12000,3000
14382337,44950,SWAP20,15000,18,18000,-3000
14525857,45005,SWAP20,9000,7,7000,2000
14531857,45007,SWAP20,5000,5,5000,0
14371779,44945,SWAP20,14000,11,11000,3000
14345292,44935,SWAP20,17000,14,14000,3000
14514147,45000,SWAP20,10000,5,5000,5000
14514147,45000,SWAP20,10000,,10000,0
14515537,45001,SWAP20,3000,5,5000,-2000
14495041,44993,SWAP20,15000,14,14000,1000
14475827,44986,SWAP20,7000,6,6000,1000
14468793,44984,SWAP20,10000,10,10000,0
14434111,44970,SWAP20,11000,7,7000,4000
14433610,44970,SWAP20,15000,10,10000,5000
14451404,44977,SWAP20,15000,14,14000,1000
14475909,44986,SWAP20,15000,13,13000,2000
14492183,44992,SWAP20,7000,,7000,0
14492183,44992,SWAP20,7000,7,7000,0
14339560,44931,SWAP20,14000,8,8000,6000
14331794,44929,SWAP20,10000,5,5000,5000
14416865,44964,SWAP20,15000,15,15000,0
14416867,44964,SWAP20,10000,10,10000,0
14408128,44960,SWAP20,14000,10,10000,4000
14371643,44945,SWAP20,8000,3,3000,5000
14385147,44951,SWAP20,12000,11,11000,1000
14356683,44939,SWAP20,14000,10,10000,4000
14509880,44999,SWAP20,11000,9,9000,2000
14471662,44985,SWAP20,9000,6,6000,3000
14471662,44985,SWAP20,9000,5,5000,4000
14527906,45006,SWAP20,10000,8,8000,2000
14527906,45006,SWAP20,10000,,10000,0
14532426,45007,SWAP20,7000,10,10000,-3000
14471675,44985,SWAP20,9000,5,5000,4000
14471675,44985,SWAP20,9000,7,7000,2000
14513849,45000,SWAP20,10000,7,7000,3000
14361673,44942,SWAP20,18000,16,16000,2000
14332451,44929,SWAP20,19000,15,15000,4000
14376084,44946,SWAP20,8000,4,4000,4000
14388514,44952,SWAP20,8000,4,4000,4000
14399770,44957,SWAP20,18000,15,15000,3000
14344533,44935,SWAP20,11000,5,5000,6000
14510328,44999,SWAP20,15000,14,14000,1000
14503054,44995,SWAP20,17000,,17000,0
14503054,44995,SWAP20,17000,17,17000,0
14479071,44987,SWAP20,13000,12,12000,1000
14535286,45008,SWAP20,15000,,15000,0
14535286,45008,SWAP20,15000,15,15000,0
14535286,45008,SWAP20,15000,15,15000,0
14528253,45006,SWAP20,12000,16,16000,-4000
14531858,45007,SWAP20,5000,10,10000,-5000
14491111,44992,SWAP20,7000,6,6000,1000
14496923,44994,SWAP20,12000,11,11000,1000
14469269,44984,SWAP20,5000,6,6000,-1000
14442681,44973,SWAP20,13000,13,13000,0
14427630,44967,SWAP20,30000,8,8000,22000
14402979,44958,SWAP20,18000,4,4000,14000
14392555,44953,SWAP20,8000,4,4000,4000
14385618,44951,SWAP20,13000,8,8000,5000
14416394,44964,SWAP20,5000,4,4000,1000
14344503,44935,SWAP20,12000,7,7000,5000
14446650,44974,SWAP20,12000,12,12000,0
14488406,44991,SWAP20,5000,4,4000,1000
14510501,44999,SWAP20,15000,21,21000,-6000
14520615,45002,SWAP20,8000,9,9000,-1000
14520615,45002,SWAP20,8000,8,8000,0
14532229,45007,SWAP20,5000,,5000,0
14532229,45007,SWAP20,5000,,5000,0
14517015,45001,SWAP20,13000,10,10000,3000
14498030,44994,SWAP20,10000,10,10000,0
14331157,44928,SWAP20,13000,13,13000,0
14331796,44929,SWAP20,9000,6,6000,3000
14375138,44946,SWAP20,8000,4,4000,4000
14388518,44952,SWAP20,8000,4,4000,4000
14507243,44998,SWAP20,9000,9,9000,0
14525862,45005,SWAP20,9000,7,7000,2000
14514829,45000,SWAP20,8000,8,8000,0
14498453,44994,SWAP20,10000,11,11000,-1000
14482607,44988,SWAP20,5000,5,5000,0
14388855,44952,SWAP20,8000,4,4000,4000
14375519,44946,SWAP20,13000,7,7000,6000
14375519,44946,SWAP20,13000,8,8000,5000
14353907,44938,SWAP20,10000,6,6000,4000
14502537,44995,SWAP20,10000,8,8000,2000
14523127,45004,SWAP20,12500,5,5000,7500
14426367,44967,SWAP20,7000,6,6000,1000
14426367,44967,SWAP20,7000,,7000,0
14339571,44931,SWAP20,11000,8,8000,3000
14382239,44950,SWAP20,8000,,8000,0
14382239,44950,SWAP20,8000,,8000,0
14382239,44950,SWAP20,8000,4,4000,4000
14419565,44965,SWAP20,9000,7,7000,2000
14421659,44965,SWAP20,8000,5,5000,3000
14423127,44966,SWAP20,5000,,5000,0
14423127,44966,SWAP20,5000,4,4000,1000
14409245,44960,SWAP20,7000,7,7000,0
14337410,44930,SWAP20,13000,7,7000,6000
14367359,44944,SWAP20,8000,4,4000,4000
14439634,44972,SWAP20,5000,4,4000,1000
14469119,44984,SWAP20,9000,9,9000,0
14520617,45002,SWAP20,12000,15,15000,-3000
14514831,45000,SWAP20,7000,6,6000,1000
14492180,44992,SWAP20,10000,8,8000,2000
14497142,44994,SWAP20,5000,5,5000,0
14482774,44988,SWAP20,5000,5,5000,0
14520533,45002,SWAP20,4000,9,9000,-5000
14375038,44946,SWAP20,8000,4,4000,4000
14388235,44952,SWAP20,8000,4,4000,4000
14415435,44963,SWAP20,8000,5,5000,3000
14511517,44999,SWAP20,11000,6,6000,5000
14498346,44994,SWAP20,10000,10,10000,0
14445001,44974,SWAP20,10000,11,11000,-1000
14538197,45009,SWAP20,9000,7,7000,2000
14385619,44951,UNKNOWN,7000,5,5000,2000
14375040,44946,SWAP20,8000,5,5000,3000
14389073,44952,SWAP20,8000,4,4000,4000
14408145,44960,SWAP20,9000,7,7000,2000
14361660,44942,SWAP20,8000,5,5000,3000
14353908,44938,SWAP20,8000,9,9000,-1000
14442693,44973,SWAP20,12000,12,12000,0
14476987,44986,SWAP20,15000,16,16000,-1000
14468794,44984,SWAP20,13000,10,10000,3000
14457460,44979,SWAP20,5000,5,5000,0
14465306,44981,SWAP20,10000,7,7000,3000
14465306,44981,SWAP20,10000,,10000,0
14494437,44993,SWAP20,5000,7,7000,-2000
14479020,44987,SWAP20,10000,8,8000,2000
14408956,44960,SWAP20,5000,4,4000,1000
14419574,44965,SWAP20,5000,5,5000,0
14445809,44974,MOB,7000,8,8000,-1000
14443254,44973,SWAP20,8000,12,12000,-4000
14457287,44979,SWAP20,5000,4,4000,1000
14461529,44980,SWAP20,5000,5,5000,0
14451284,44977,SWAP20,12000,14,14000,-2000
14482979,44988,SWAP20,5000,,5000,0
14510503,44999,SWAP20,15000,16,16000,-1000
14502840,44995,SWAP20,7000,,7000,0
14502840,44995,SWAP20,7000,7,7000,0
14401997,44958,SWAP20,18000,15,15000,3000
14412961,44963,SWAP20,12000,11,11000,1000
14388866,44952,SWAP20,17000,,17000,0
14388866,44952,SWAP20,17000,13,13000,4000
14371213,44945,SWAP20,8000,4,4000,4000
14516964,45001,SWAP20,12000,15,15000,-3000
14495042,44993,SWAP20,7000,,7000,0
14495042,44993,SWAP20,7000,7,7000,0
14495042,44993,SWAP20,7000,7,7000,0
14464030,44981,SWAP20,6000,10,10000,-4000
14457659,44979,SWAP20,7000,6,6000,1000
14529557,45006,SWAP20,5000,4,4000,1000
14464024,44981,SWAP20,3000,4,4000,-1000
14464024,44981,SWAP20,3000,,3000,0
14464024,44981,SWAP20,3000,,3000,0
14478555,44987,SWAP20,5000,5,5000,0
14470315,44984,SWAP20,7000,6,6000,1000
14451286,44977,SWAP20,3000,8,8000,-5000
14434113,44970,SWAP20,10000,9,9000,1000
14368017,44944,SWAP20,8000,5,5000,3000
14368017,44944,SWAP20,8000,,8000,0
14345378,44935,SWAP20,18000,15,15000,3000
14382645,44950,SWAP20,8000,,8000,0
14382645,44950,SWAP20,8000,,8000,0
14382645,44950,SWAP20,8000,4,4000,4000
14446240,44974,SWAP20,11000,12,12000,-1000
14476957,44986,SWAP20,5000,5,5000,0
14520655,45002,SWAP20,5000,5,5000,0
14507332,44998,SWAP20,14000,16,16000,-2000
14468906,44984,SWAP20,8000,6,6000,2000
14382292,44950,SWAP20,9000,6,6000,3000
14392561,44953,SWAP20,8000,4,4000,4000
14364708,44943,SWAP20,8000,5,5000,3000
14532431,45007,SWAP20,16000,16,16000,0
14364337,44943,SWAP20,8000,5,5000,3000
14347885,44936,SWAP20,18000,15,15000,3000
14382456,44950,SWAP20,13000,15,15000,-2000
14471738,44985,SWAP20,4000,4,4000,0
14464695,44981,SWAP20,10000,13,13000,-3000
14483045,44990,SWAP20,12000,11,11000,1000
14491278,44992,SWAP20,15000,13,13000,2000
14520619,45002,SWAP20,17000,,17000,0
14520619,45002,SWAP20,17000,17,17000,0
14464697,44981,SWAP20,5000,5,5000,0
14457660,44979,SWAP20,8000,8,8000,0
14416869,44964,SWAP20,7000,6,6000,1000
14424855,44966,SWAP20,14000,14,14000,0
14465523,44981,SWAP20,14000,9,9000,5000
14502957,44995,SWAP20,9000,11,11000,-2000
14382240,44950,SWAP20,8000,8,8000,0
14526695,45005,SWAP20,5000,4,4000,1000
14396145,44956,SWAP20,8000,4,4000,4000
14396145,44956,SWAP20,8000,,8000,0
14396145,44956,SWAP20,8000,,8000,0
14411999,44963,SWAP20,5000,4,4000,1000
14475765,44986,SWAP20,10000,10,10000,0
14451039,44977,SWAP20,3000,4,4000,-1000
14453939,44978,SWAP20,10000,15,15000,-5000
14471445,44985,SWAP20,15000,17,17000,-2000
14487192,44991,SWAP20,12000,10,10000,2000
14424868,44966,SWAP20,16000,15,15000,1000
14399238,44957,SWAP20,16000,16,16000,0
14399238,44957,SWAP20,16000,14,14000,2000
14392611,44953,SWAP20,17000,15,15000,2000
14375139,44946,SWAP20,8000,5,5000,3000
14356697,44939,SWAP20,17000,17,17000,0
14524641,45005,SWAP20,11000,8,8000,3000
14532589,45007,SWAP20,6000,6,6000,0
14487945,44991,SWAP20,14000,,14000,0
14502055,44995,SWAP20,10000,,10000,0
14502055,44995,SWAP20,10000,12,12000,-2000
14514097,45000,SWAP20,5000,4,4000,1000
14465138,44981,SWAP20,3000,4,4000,-1000
14425712,44967,SWAP20,8000,11,11000,-3000
14437714,44971,SWAP20,5000,5,5000,0
14502919,44995,SWAP20,15000,16,16000,-1000
14483050,44988,SWAP20,13000,12,12000,1000
14356699,44939,SWAP20,9000,4,4000,5000
14345413,44935,SWAP20,15000,14,14000,1000
14375196,44946,SWAP20,8000,4,4000,4000
14496994,44994,SWAP20,13000,11,11000,2000
14514151,45000,SWAP20,11000,6,6000,5000
14475726,44986,SWAP20,12000,16,16000,-4000
14532592,45007,SWAP20,17000,17,17000,0
14525416,45005,SWAP20,15000,15,15000,0
14525416,45005,SWAP20,15000,,15000,0
14468908,44984,SWAP20,13000,15,15000,-2000
14461539,44980,SWAP20,7000,7,7000,0
14510505,44999,SWAP20,10000,10,10000,0
14498377,44994,SWAP20,5000,4,4000,1000
14482605,44988,SWAP20,5000,5,5000,0
14367931,44944,SWAP20,19000,17,17000,2000
14381343,44949,SWAP20,18000,17,17000,1000
14392596,44953,SWAP20,19000,18,18000,1000
14405168,44959,SWAP20,13000,4,4000,9000
14422414,44966,SWAP20,5000,5,5000,0
14482996,44988,SWAP20,11000,14,14000,-3000
14510485,44999,SWAP20,8000,6,6000,2000
14457668,44979,SWAP20,5000,5,5000,0
14439181,44972,SWAP20,5000,5,5000,0
14451403,44977,SWAP20,15000,8,8000,7000
14471608,44985,SWAP20,15000,13,13000,2000
14502487,44995,SWAP20,12000,,12000,0
14502487,44995,SWAP20,12000,18,18000,-6000
14407753,44960,SWAP20,5000,5,5000,0
14382338,44950,SWAP20,15000,10,10000,5000
14347310,44936,SWAP20,13000,13,13000,0
14338892,44931,SWAP20,8000,5,5000,3000
14356717,44939,SWAP20,8000,5,5000,3000
14416397,44964,SWAP20,5000,,5000,0
14514828,45000,SWAP20,10000,7,7000,3000
14471751,44985,SWAP20,13000,13,13000,0
14451186,44977,SWAP20,10000,9,9000,1000
14433748,44970,SWAP20,5000,5,5000,0
14469247,44984,SWAP20,15000,15,15000,0
14528138,45006,SWAP20,13000,10,10000,3000
14468795,44984,SWAP20,9000,7,7000,2000
14433613,44970,SWAP20,12000,13,13000,-1000
14516519,45001,SWAP20,6000,,6000,0
14516519,45001,SWAP20,6000,5,5000,1000
14421630,44965,SWAP20,15000,5,5000,10000
14364689,44943,SWAP20,15000,14,14000,1000
14329992,44928,SWAP20,13000,10,10000,3000
14380038,44949,SWAP20,19000,17,17000,2000
14488257,44991,SWAP20,23000,24,24000,-1000
14528140,45006,SWAP20,10000,8,8000,2000
14488013,44991,SWAP20,15000,,15000,0
14488013,44991,SWAP20,15000,13,13000,2000
14347829,44936,SWAP20,8000,4,4000,4000
14408187,44960,SWAP20,5000,7,7000,-2000
14402005,44958,SWAP20,10000,11,11000,-1000
14425730,44967,SWAP20,3000,4,4000,-1000
14442281,44973,SWAP20,5000,4,4000,1000
14442652,44973,SWAP20,5000,4,4000,1000
14520677,45002,SWAP20,13000,10,10000,3000
14424490,44966,SWAP20,3000,5,5000,-2000
14353910,44938,SWAP20,8000,9,9000,-1000
14339576,44931,SWAP20,3000,659,6590,-3590
14339562,44931,SWAP20,12000,10,10000,2000
14331049,44928,SWAP20,4200,10,10000,-5800
14348347,44936,SWAP20,8000,3,3000,5000
14361661,44942,SWAP20,16000,16,16000,0
14376179,44946,SWAP20,8000,4,4000,4000
14389265,44952,SWAP20,9000,6,6000,3000
14353942,44938,SWAP20,13000,10,10000,3000
14331777,44929,SWAP20,10000,7,7000,3000
14347315,44936,SWAP20,9000,4,4000,5000
14364621,44943,SWAP20,13000,11,11000,2000
14399144,44957,SWAP20,13000,10,10000,3000
14520967,45004,SWAP20,13000,12,12000,1000
14468800,44984,SWAP20,10000,12,12000,-2000
14537920,45009,SWAP20,7000,,7000,0
14442695,44973,SWAP20,10000,12,12000,-2000
14433621,44970,SWAP20,6000,6,6000,0
14405169,44959,SWAP20,5000,4,4000,1000
14419134,44965,SWAP20,5000,4,4000,1000
14388409,44952,SWAP20,15000,8,8000,7000
14396058,44956,SWAP20,10000,6,6000,4000
14418431,44964,SWAP20,8000,7,7000,1000
14464699,44981,SWAP20,5000,4,4000,1000
14510456,44999,SWAP20,10000,9,9000,1000
14510456,44999,SWAP20,10000,,10000,0
14482695,44988,SWAP20,3000,4,4000,-1000
14364690,44943,SWAP20,18000,15,15000,3000
14351055,44937,SWAP20,10000,10,10000,0
14397036,44956,SWAP20,16000,16,16000,0
14424474,44966,SWAP20,3000,7,7000,-4000
14495246,44993,SWAP20,9000,6,6000,3000
14475828,44986,SWAP20,12000,16,16000,-4000
14447015,44974,SWAP20,5000,5,5000,0
14454402,44978,SWAP20,14000,12,12000,2000
14433626,44970,SWAP20,10000,10,10000,0
14353911,44938,SWAP20,17000,16,16000,1000
14382458,44950,SWAP20,18000,13,13000,5000
14510486,44999,SWAP20,20000,16,16000,4000
14502047,44995,TC20,23000,24,24000,-1000
14502047,44995,TC20,23000,,23000,0
14445475,44977,TC20,29000,24,24000,5000
14325385,44930,TC20,31000,31,31000,0
14341541,44938,TC20,31000,31,31000,0
14445471,44978,TC20,29000,24,24000,5000
14516425,45007,TC20,31000,31,31000,0
14445484,44977,TC20,5000,4,4000,1000
14371578,44950,TC20,5000,5,5000,0
14371578,44950,TC20,5000,,5000,0
14414681,44965,TC20,5000,4,4000,1000
14341779,44936,TC20,5000,5,5000,0
14325283,44929,TC20,5000,5,5000,0
14325283,44929,TC20,5000,,5000,0
14515031,45002,TC20,5000,5,5000,0
14434617,44972,TC20,5000,4,4000,1000
14427246,44970,TC20,5000,5,5000,0
14457358,44984,TC20,5000,5,5000,0
14369738,44949,TC20,5000,4,4000,1000
14369738,44949,TC20,5000,,5000,0
14369738,44949,TC20,5000,,5000,0
14531805,45008,TC20,5000,4,4000,1000
14479531,44988,TC20,43000,4,4000,39000
14447200,44979,TC20,5000,5,5000,0
14404044,44960,TC20,20000,20,20000,0
14408204,44964,TC30,6000,6,6000,0
14345968,44936,TC30,6000,6,6000,0
14537499,45009,CON30,22000,,22000,0
14409083,44965,CON30,4000,4,4000,0
14518145,45007,CON30,4000,3,3000,1000
14341620,44936,CON30,4000,4,4000,0
14336631,44930,CON30,36000,32,32000,4000
14381309,44949,CON30,38000,,38000,0
14381309,44949,CON30,38000,32,32000,6000
14469422,44984,CON30,28000,32,32000,-4000
14437584,44971,CON30,4000,4,4000,0
14349167,44936,CON30,35000,31,31000,4000
14533727,45008,CON30,30000,,30000,0
14340096,44938,CON30,4000,3,3000,1000
14409103,44966,CON30,4000,5,5000,-1000
14399350,44957,CON30,33000,31,31000,2000
14453792,44979,CON30,4000,3,3000,1000
14437961,44972,TC40,30600,30,30000,600
14478529,44987,TC40,7000,4,4000,3000
14393051,44956,TC40,28050,28,28000,50
14520408,45008,TC40,30550,32,32000,-1450
14520419,45007,TC40,30550,30,30000,550
14491138,44994,TC40,30550,31,31000,-450
14453032,44978,TC40,27550,27,27000,550
14375542,44950,CON40,28000,28,28000,0
14408247,44963,TC40,29550,29,29000,550
14375538,44950,TC40,34000,34,34000,0
14453034,44978,TC40,30550,30,30000,550
14392659,44956,TC40,7000,7,7000,0
14472254,44988,TC40,30550,30,30000,550
14497223,44999,TC40,29550,30,30000,-450
14497225,44999,TC40,28050,28,28000,50
14368550,44944,CON40,4000,4,4000,0
14516762,45001,TC40,29600,30,30000,-400
14325504,44929,CON40,29000,29,29000,0
14392661,44956,CON40,32000,31,31000,1000
14455851,44979,TC40,27600,27,27000,600
14416935,44964,TC40,30600,30,30000,600
14409615,44963,TC40,30600,30,30000,600
14521257,45006,TC40,35000,30,30000,5000
14497221,45002,TC40,30500,32,32000,-1500
14497224,44999,TC40,24001,24,24000,1
14348983,44939,TC40,35000,35,35000,0
14348985,44938,TC40,35000,35,35000,0
14383592,44951,TC40,32000,32,32000,0
14455848,44980,TC40,26600,27,27000,-400
14462382,44984,TC40,29600,29,29000,600
14325502,44929,TC40,35000,35,35000,0
14419162,44965,TC40,30600,30,30000,600
14427597,44970,TC40,35000,32,32000,3000
14446703,44974,TC40,7000,7,7000,0
14402689,44958,TC40,7000,4,4000,3000
14408246,44963,TC40,30600,31,31000,-400
14462384,44984,TC40,30500,31,31000,-500
14462378,44981,TC40,30600,31,31000,-400
14494406,44994,TRA,31000,,31000,0
14402719,44958,CON20,9000,4,4000,5000
14472514,44992,CON40,24000,23,23000,1000
14494463,44993,CON40,24000,,24000,0
14494463,44993,CON40,24000,24,24000,0
14404621,44963,CON40,28000,23,23000,5000
14509831,45000,CON40,24000,24,24000,0
14357777,44943,CON40,29000,23,23000,6000
14404624,44963,CON40,27000,23,23000,4000
14509842,45000,CON40,24000,24,24000,0
14404625,44963,CON40,28000,23,23000,5000
14487986,44993,CON40,25000,,25000,0
14487986,44993,CON40,25000,25,25000,0
14487986,44993,CON40,25000,,25000,0
14324860,44928,CON40,17000,12,12000,5000
14402715,44958,CON40,14400,10,10000,4400
14510062,45000,CON40,24000,24,24000,0
14510062,45000,CON40,24000,,24000,0
14447206,44978,CON30,4000,4,4000,0
14422387,44970,CON30,4000,4,4000,0
14379755,44949,CON30,35000,32,32000,3000
14345567,44935,CON30,38000,33,33000,5000
14463817,44984,TRA,25000,18,18000,7000
14472466,44985,TRA,31000,27,27000,4000
14408190,44960,KTA,11000,7,7000,4000
14408190,44960,KTA,11000,,11000,0
14402695,44958,TRA,18000,8,8000,10000
14396060,44956,TRA,23000,10,10000,13000
14389272,44952,TRA,18000,11,11000,7000
14347492,44937,TRA,35000,10,10000,25000
14362584,44943,TRA,35000,20,20000,15000
14457332,44979,TRA,24000,11,11000,13000
14508647,44998,TRA,25000,25,25000,0
14480350,44987,TRA,25000,20,20000,5000
14524478,45005,TRA,15000,11,11000,4000
14446630,44974,TRA,23000,,23000,0
14446630,44974,TRA,23000,,23000,0
14446630,44974,TRA,23000,18,18000,5000
14385846,44951,TRA,35000,34,34000,1000
14368111,44944,TRA,42000,,42000,0
14368111,44944,TRA,42000,,42000,0
14368111,44944,TRA,42000,34,34000,8000
14437683,44971,TRA,42000,35,35000,7000
14447094,44974,TRA,22000,,22000,0
14447094,44974,TRA,22000,,22000,0
14447094,44974,TRA,22000,22,22000,0
14329803,44929,CON45,33000,28,28000,5000
14333054,44929,TRA,39000,33,33000,6000
14368012,44944,TRA,39000,33,33000,6000
14418320,44964,TRA,28000,27,27000,1000
14437659,44971,TRA,32000,17,17000,15000
14462704,44980,TRA,25000,20,20000,5000
14488402,44991,TRA,32000,19,19000,13000
14514973,45000,TRA,32000,29,29000,3000
14528498,45006,TRA,25000,12,12000,13000
14531409,45008,CON20,2000,4,4000,-2000
14354607,44938,TRA,14000,15,15000,-1000
14510525,44999,TRA,25000,15,15000,10000
14483386,44988,TRA,32000,10,10000,22000
14458941,44979,TRA,32000,28,28000,4000
14361044,44943,TC20,30478,25,25000,5478
14358150,44942,TC20,5000,5,5000,0
14481764,44991,TC20,27060,,27060,0
14481764,44991,TC20,27060,27,27000,60
14521862,45009,TC20,26620,26,26000,620
14435433,44972,TC20,26620,26,26000,620
14465098,44984,TC25,29960,29,29000,960
14388317,44956,TC20,29160,29,29000,160
14329849,44929,TC20,29080,29,29000,80
14517622,45002,TC20,5000,5,5000,0
14517622,45002,TC20,5000,,5000,0
14482387,44999,TC20,5000,4,4000,1000
14482387,44999,TC20,5000,5,5000,0
14316528,44936,TC20,5000,5,5000,0
14374935,44952,TC20,5000,4,4000,1000
14408306,44971,TC20,5000,5,5000,0
14414143,44964,TC30,38000,32,32000,6000
14357738,44943,TC30,38000,32,32000,6000
14325028,44936,TC20,5000,5,5000,0
14424824,44974,TC20,5000,5,5000,0
14374938,44959,TC20,5000,5,5000,0
14482446,44999,TC20,5000,5,5000,0
14489844,44992,TC30,32000,32,32000,0
14357742,44943,TC30,38000,32,32000,6000
14357405,44949,TC20,5000,5,5000,0
14345957,44936,TC30,38000,32,32000,6000
14514160,45006,TC30,33000,32,32000,1000
14456673,44984,TC30,39000,30,30000,9000
14456673,44984,TC30,39000,30,30000,9000
14496454,44995,TC20,5000,5,5000,0
14316529,44930,TC20,5000,4,4000,1000
14426580,44971,CON30,35000,32,32000,3000
14325027,44937,TC20,5000,5,5000,0
14389945,44963,TC20,5000,5,5000,0
14385500,44951,TC30,38000,32,32000,6000
14408307,44967,TC20,5000,5,5000,0
14301817,44928,TC20,5000,5,5000,0
14357407,44946,TC20,5000,5,5000,0
14519990,45009,TC20,5000,5,5000,0
14351496,44939,TC30,38000,30,30000,8000
14482444,44994,TC20,5000,5,5000,0
14490433,44992,TC30,32000,,32000,0
14446623,44980,TC30,6000,5,5000,1000
14357406,44946,TC30,6000,5,5000,1000
14336493,44936,TC30,38000,31,31000,7000
14392250,44957,TC30,38000,31,31000,7000
14426581,44971,CON30,35000,31,31000,4000
14519991,45009,TC20,5000,5,5000,0
14374936,44959,TC20,5000,5,5000,0
14353294,44939,TC20,5000,5,5000,0
14375239,44950,TC30,38000,32,32000,6000
14374937,44957,TC20,5000,4,4000,1000
14408308,44972,TC20,5000,4,4000,1000
14340788,44938,TC20,5000,5,5000,0
14418900,44965,TC26,37000,32,32000,5000
14514158,45006,TC30,32000,32,32000,0
14502561,45000,TC20,5000,5,5000,0
14340789,44942,TC20,5000,5,5000,0
14336495,44936,TC30,38000,32,32000,6000
14482445,44997,TC20,5000,5,5000,0
14446622,44980,TC30,6000,5,5000,1000
14477664,44992,TC30,33000,31,31000,2000
14353293,44939,TC30,6000,5,5000,1000
14389947,44964,TC30,6000,5,5000,1000
14340787,44939,TC20,5000,5,5000,0
14502560,45002,TC20,5000,5,5000,0
14508343,44999,TC30,36000,31,31000,5000
14336316,44935,TC30,38000,32,32000,6000
14346144,44936,TC20,0,5,5000,-5000
14517609,45002,TC20,5000,5,5000,0
14534674,45009,TC20,5000,,5000,0
14437653,44972,TC20,5000,4,4000,1000
14331128,44929,TC20,5000,4,4000,1000
14447138,44977,TC20,20750,21,21000,-250
14509209,44999,TC26,5000,,5000,0
14509209,44999,TC26,5000,5,5000,0
14416038,44965,TC23,29820,30,30000,-180
14501308,45002,TC20,32070,32,32000,70
14390566,44953,TC20,5000,5,5000,0
14466321,44988,TC20,23380,23,23000,380
14503877,45002,TC26,31000,30,30000,1000
14396529,44960,TC20,29520,28,28000,1520
14515753,45007,TC25,27940,28,28000,-60
14466322,44988,TC25,32420,32,32000,420
14353136,44939,TC25,28380,29,29000,-620
14340185,44935,TC20,31000,31,31000,0
14412974,44965,TC20,5000,4,4000,1000
14526268,45006,TC20,5000,4,4000,1000
14470636,44985,TC20,5000,5,5000,0
14434851,44971,TC20,5000,5,5000,0
14438493,44973,TC20,27020,28,28000,-980
14418283,44966,TC20,22020,22,22000,20
14404664,44960,TC25,29880,30,30000,-120
14477846,44991,TC20,28920,29,29000,-80
14493905,44998,TC25,29940,30,30000,-60
14518529,45001,TC23,5000,,5000,0
14518529,45001,TC23,5000,4,4000,1000
14518529,45001,TC23,5000,,5000,0
14518529,45001,TC23,5000,,5000,0
14501573,45001,TC25,30040,31,31000,-960
14349984,44938,TC25,29940,29,29000,940
14466324,44988,TC25,30000,30,30000,0
14492313,44994,TC26,29940,30,30000,-60
14465481,44987,TC20,29860,30,30000,-140
14466320,44988,TC20,29940,30,30000,-60
14474707,44992,TC25,30060,30,30000,60
14419096,44966,TC25,29660,29,29000,660
14413178,44964,TC25,29840,29,29000,840
14387393,44952,TC20,5000,5,5000,0
14398528,44959,TC25,30940,31,31000,-60
14376140,44949,TC26,30940,30,30000,940
14396027,44957,TC23,30000,30,30000,0
14367402,44945,TC26,31060,32,32000,-940
14382355,44951,TC26,31040,31,31000,40
14376136,44949,TC26,31000,31,31000,0
14367400,44945,TC26,31080,31,31000,80
14347101,44937,TC26,31000,31,31000,0
14422366,44967,TC26,30840,30,30000,840
14336210,44935,TC23,31200,31,31000,200
14501577,45000,TC26,30920,30,30000,920
14419099,44966,TC26,30940,30,30000,940
14384931,44956,TC20,32460,32,32000,460
14413177,44964,TC26,30940,30,30000,940
14340181,44935,TC26,32920,31,31000,1920
14331624,44936,TC26,31120,30,30000,1120
14385889,44952,TC26,31000,31,31000,0
14349987,44938,TC26,30960,30,30000,960
14376135,44949,TC26,31080,32,32000,-920
14388389,44953,TC26,30940,32,32000,-1060
14441751,44978,TC20,32710,34,34000,-1290
14396026,44957,TC26,30940,31,31000,-60
14331635,44930,TC20,29060,30,30000,-940
14349686,44939,TC20,29060,269,26900,2160
14462596,44986,TC20,29840,31,31000,-1160
14524602,45008,TC20,28880,28,28000,880
14352600,44942,TC20,35840,30,30000,5840
14398530,44958,TC20,29820,29,29000,820
14328539,44928,TC20,31500,31,31000,500
14425671,44967,TC20,28450,28,28000,450
14418917,44966,TC20,26940,26,26000,940
14446998,44977,TC20,26940,30,30000,-3060
14505925,44998,TC20,26870,27,27000,-130
14361503,44943,TC25,30620,30,30000,620
14374327,44960,TC20,22450,22,22000,450
14439751,44972,TC20,5000,4,4000,1000
14480854,44999,TC20,27040,25,25000,2040
14340777,44935,TC20,31740,28,28000,3740
14352602,44938,TC20,32090,27,27000,5090
14495843,45001,TC20,29160,30,30000,-840
14432884,44971,TC20,29640,30,30000,-360
14462594,44985,TC20,29740,30,30000,-260
14361502,44943,TC23,28340,28,28000,340
14331636,44930,TC20,28520,29,29000,-480
14453421,44980,TC20,28520,28,28000,520
14471503,44991,TC20,29780,30,30000,-220
14481765,44991,TC20,27520,28,28000,-480
14396062,44963,TC20,28920,28,28000,920
14331627,44930,TC20,26260,26,26000,260
14339830,44931,TC20,32000,27,27000,5000
14506162,44998,TC20,30360,30,30000,360
14515755,45007,TC25,29780,29,29000,780
14336290,44936,TC20,30570,30,30000,570
14379310,44950,TC25,29960,29,29000,960
14404663,44960,TC23,30980,30,30000,980
14398531,44958,TC26,29980,29,29000,980
14462592,44986,TC26,30100,30,30000,100
14401613,44959,TC25,31020,,31020,0
14401613,44959,TC25,31020,,31020,0
14401613,44959,TC25,31020,,31020,0
14512742,45006,TC26,30940,30,30000,940
14331630,44930,TC26,31000,,31000,0
14460192,44981,TC25,30000,30,30000,0
14401614,44959,TC26,30940,,30940,0
14401614,44959,TC26,30940,,30940,0
14401614,44959,TC26,30940,,30940,0
14426874,44970,TC26,29580,30,30000,-420
14483959,44994,TC26,30100,30,30000,100
14392963,44956,TC26,30960,31,31000,-40
14370559,44946,TC25,29860,29,29000,860
14519739,45008,TC25,29740,29,29000,740
14410943,44963,TC23,29860,30,30000,-140
14419098,44966,TC25,29780,27,27000,2780
14336209,44936,TC25,29420,29,29000,420
14358144,44942,TC25,29900,30,30000,-100
14396064,44959,TC23,30000,30,30000,0
14396064,44959,TC23,30000,,30000,0
14365224,44944,TC20,31580,31,31000,580
14338891,44931,TC20,34710,30,30000,4710
14462595,44984,TC23,29920,30,30000,-80
14515754,45007,TC25,29780,29,29000,780
14490560,44992,TC23,6170,,6170,0
14490560,44992,TC23,6170,4,4000,2170
14367401,44945,TC25,29760,29,29000,760
14515752,45007,TC25,29760,30,30000,-240
14503875,45002,TC23,30440,30,30000,440
14509569,45005,TC23,30880,30,30000,880
14385888,44952,TC26,30880,31,31000,-120
14353032,44939,TC26,30720,30,30000,720
14503878,45002,TC20,31860,30,30000,1860
14502045,44998,TC20,5000,5,5000,0
14381332,44950,TC20,5000,4,4000,1000
14418018,44966,TC20,5000,5,5000,0
14419795,44972,TC20,5000,4,4000,1000
14367367,44950,TC20,33000,25,25000,8000
14369662,44956,TC20,5000,5,5000,0
14314663,44937,TC20,5000,5,5000,0
14478794,44994,TC20,5000,5,5000,0
14464098,44986,TC20,33000,29,29000,4000
14458546,45007,TC20,5000,5,5000,0
14357384,44951,TC20,5000,4,4000,1000
14419796,44972,TC20,5000,4,4000,1000
14375232,44950,TC20,33000,,33000,0
14375232,44950,TC20,33000,26,26000,7000
14458545,44991,TC20,5000,5,5000,0
14463956,44985,TC20,33000,,33000,0
14442644,44978,TC20,5000,5,5000,0
14498080,44998,TC20,28000,28,28000,0
14498080,44998,TC20,28000,,28000,0
14383205,44965,TC20,5000,4,4000,1000
14386492,44956,TC20,29000,25,25000,4000
14405152,44969,TC20,5000,5,5000,0
14404603,44963,TC20,34000,29,29000,5000
14353892,44946,TC20,5000,5,5000,0
14362300,44943,TC20,33000,28,28000,5000
14245550,44931,TC20,5000,5,5000,0
14512704,45005,TC20,28000,,28000,0
14512704,45005,TC20,28000,28,28000,0
14458543,44987,TC20,5000,5,5000,0
14426578,44971,CON20,30000,,30000,0
14426578,44971,CON20,30000,28,28000,2000
14478795,45007,TC20,5000,5,5000,0
14471431,44991,TC20,28000,29,29000,-1000
14332604,44950,TC20,5000,4,4000,1000
14336488,44936,TC20,34000,28,28000,6000
14405155,44963,TC20,5000,5,5000,0
14419794,44976,TC20,5000,5,5000,0
14386501,44957,TC20,30000,25,25000,5000
14383204,44963,TC20,5000,5,5000,0
14336312,44935,TC20,34000,28,28000,6000
14332605,44938,TC20,5000,5,5000,0
14478796,45007,TC20,5000,5,5000,0
14477683,44993,TC20,28000,,28000,0
14442643,44978,TC20,5000,5,5000,0
14458544,44987,TC20,5000,5,5000,0
14456671,44984,TC20,33000,26,26000,7000
14456671,44984,TC20,33000,25,25000,8000
14245548,44931,TC20,5000,5,5000,0
14369663,44953,TC20,5000,5,5000,0
14367349,44949,TC20,33000,26,26000,7000
14405154,44969,TC20,5000,5,5000,0
14407755,44964,TC20,33000,28,28000,5000
14332606,44939,TC20,5000,5,5000,0
14336486,44936,TC20,34000,28,28000,6000
14442645,44980,TC20,5000,5,5000,0
14444110,44977,TC20,33000,28,28000,5000
14444110,44977,TC20,33000,,33000,0
14508330,44999,TC20,31000,28,28000,3000
14508329,44999,TC20,31000,28,28000,3000
14444099,44977,TC20,33000,29,29000,4000
14442646,44980,TC20,5000,5,5000,0
14294260,44930,TC20,5000,3,3000,2000
14353893,44949,TC20,5000,5,5000,0
14357681,44943,TC20,34000,30,30000,4000
14405153,44965,TC20,5000,4,4000,1000
14426678,44972,CON20,31000,29,29000,2000
14472504,44992,TC20,28000,29,29000,-1000
14419797,44976,TC20,5000,5,5000,0
14383203,44963,TC20,5000,5,5000,0
14386497,44956,TC20,29000,24,24000,5000
14353891,44944,TC20,5000,5,5000,0
14531698,45007,TC20,20490,25,25000,-4510
14531698,45007,TC20,20490,26,26000,-5510
14521270,45005,TC20,5000,5,5000,0
14519335,45008,TC20,21970,27,27000,-5030
14516990,45005,TC20,5000,5,5000,0
14516990,45005,TC20,5000,,5000,0
14348904,44937,TC20,5000,5,5000,0
14400196,44958,TC20,5000,5,5000,0
14521269,45005,TC20,0,5,5000,-5000
14512152,45006,TC20,26775,26,26000,775
14406068,44963,TC20,5000,5,5000,0
14509373,44999,TC20,5000,5,5000,0
14463683,44987,TC20,28040,30,30000,-1960
14364120,44945,TC20,27650,27,27000,650
14348905,44937,TC20,5000,5,5000,0
14332603,44930,TC20,5000,5,5000,0
14330979,44929,TC20,5000,5,5000,0
14456527,44980,TC20,26060,27,27000,-940
14521247,45005,TC20,5000,5,5000,0
14445437,44977,TC20,29000,29,29000,0
14462597,44991,TC20,26900,28,28000,-1100
14510547,44999,TC20,5000,3,3000,2000
14510547,44999,TC20,5000,,5000,0
14432546,44971,TC20,26730,27,27000,-270
14352598,44938,TC20,32740,28,28000,4740
14410945,44964,TC20,29220,29,29000,220
14398525,44958,TC26,30960,31,31000,-40
14398526,44958,TC26,30900,30,30000,900
14349988,44938,TC26,30900,30,30000,900
14364224,44944,TC26,30980,30,30000,980
14385883,44952,TC26,30800,31,31000,-200
14391582,44953,TC20,5000,5,5000,0
14468574,44984,TC20,5000,5,5000,0
14392444,44956,TC20,5000,5,5000,0
14349986,44938,TC26,30980,30,30000,980
14401616,44959,TC26,31180,,31180,0
14401616,44959,TC26,31180,,31180,0
14401616,44959,TC26,31180,,31180,0
14447004,44977,TC26,31020,31,31000,20
14388385,44953,TC26,30880,32,32000,-1120
14392957,44956,TC26,30840,31,31000,-160
14344331,44937,TC26,31120,31,31000,120
14501574,45001,TC25,30940,30,30000,940
14370560,44946,TC26,30980,31,31000,-20
14331625,44931,TC23,27800,,27800,0
14331625,44931,TC23,27800,,27800,0
14477841,44993,TC20,28760,30,30000,-1240
14440011,44974,TC20,29150,29,29000,150
14496073,45000,TC23,29960,29,29000,960
14344329,44937,TC26,31040,30,30000,1040
14447001,44977,TC26,29800,30,30000,-200
14450726,44978,TC26,29980,30,30000,-20
14347099,44937,TC26,31120,31,31000,120
14435710,44972,TC23,30000,30,30000,0
14353034,44939,TC23,29900,29,29000,900
14422367,44967,TC25,29900,29,29000,900
14358140,44942,TC26,29900,30,30000,-100
14373027,44946,TC20,32840,28,28000,4840
14373027,44946,TC20,32840,28,28000,4840
14385884,44952,TC25,29760,30,30000,-240
14401618,44959,TC26,30960,30,30000,960
14509568,45005,TC26,31100,30,30000,1100
14475705,44991,TC20,21960,21,21000,960
14391583,44953,TC20,23770,24,24000,-230
14521245,45005,TC20,5000,5,5000,0
14471504,44991,TC20,25960,30,30000,-4040
14435434,44974,TC20,29040,30,30000,-960
14463687,44987,TC20,25940,26,26000,-60
14391540,44956,TC20,20820,25,25000,-4180
14521229,45005,TC20,5000,4,4000,1000
14495844,45001,TC20,31710,31,31000,710
14509565,45005,TC26,30920,30,30000,920
14503880,45002,TC26,29980,30,30000,-20
14450724,44979,TC26,29780,29,29000,780
14410944,44963,TC26,30960,30,30000,960
14510777,45005,TC20,26775,27,27000,-225
14466323,44988,TC20,29920,30,30000,-80
14524603,45008,TC20,28940,29,29000,-60
14463685,44987,TC20,29940,30,30000,-60
14329825,44930,TC20,29720,,29720,0
14329825,44930,TC20,29720,,29720,0
14367426,44957,TC20,32220,32,32000,220
14492316,44994,TC25,30020,30,30000,20
14419100,44966,TC25,29880,30,30000,-120
14408265,44963,TC20,28290,30,30000,-1710
14401615,44959,TC23,30000,30,30000,0
14379308,44950,TC20,29920,29,29000,920
14515720,45009,TC20,30220,30,30000,220
14361501,44943,TC25,29900,30,30000,-100
14466325,44987,TC20,29820,30,30000,-180
14439302,44973,TC23,29860,29,29000,860
14458812,44985,TC20,30270,31,31000,-730
14331628,44930,TC25,30060,30,30000,60
14510551,44999,TC20,5000,3,3000,2000
14510551,44999,TC20,5000,,5000,0
14510551,44999,TC20,5000,,5000,0
14510551,44999,TC20,5000,4,4000,1000
14347100,44937,TC26,31020,31,31000,20
14344328,44936,TC26,31060,31,31000,60
14370558,44946,TC26,31000,31,31000,0
14398527,44958,TC26,31020,31,31000,20
14404665,44960,TC26,30900,30,30000,900
14441215,44973,TC26,30920,30,30000,920
14501579,45000,TC26,30840,30,30000,840
14386693,44957,TC20,32710,32,32000,710
14382221,44957,TC20,33470,33,33000,470
14422368,44967,TC26,30820,31,31000,-180
14413179,44964,TC26,30960,30,30000,960
14361499,44945,TC26,30840,30,30000,840
14358145,44942,TC26,30780,30,30000,780
14336207,44931,TC26,31000,,31000,0
14336207,44931,TC26,31000,,31000,0
14358143,44942,TC26,31000,31,31000,0
14426876,44970,TC26,29780,30,30000,-220
14519741,45008,TC26,32460,32,32000,460
14512739,45006,TC26,30900,30,30000,900
14404662,44960,TC26,30860,30,30000,860
14329827,44929,TC26,33000,33,33000,0
14503331,44995,TC20,5000,5,5000,0
14349985,44938,TC26,31040,31,31000,40
14383071,44951,TC26,31000,30,30000,1000
14457432,44981,TC26,30920,30,30000,920
14519740,45008,TC26,32420,31,31000,1420
14385875,44952,TC26,30900,31,31000,-100
14501578,45001,TC26,30860,31,31000,-140
14398529,44959,TC26,31000,31,31000,0
14486421,44999,TC20,32170,32,32000,170
14392961,44956,TC25,31040,31,31000,40
14468577,44991,TC20,32170,30,30000,2170
14502879,44995,TC20,5000,,5000,0
14502879,44995,TC20,5000,,5000,0
14502879,44995,TC20,5000,4,4000,1000
14463686,44987,TC26,29920,29,29000,920
14353036,44939,TC26,30660,30,30000,660
14336208,44935,TC26,32960,32,32000,960
14385894,44952,TC26,30840,31,31000,-160
14503876,45002,TC26,31100,32,32000,-900
14496074,45000,TC26,30920,31,31000,-80
14436314,44972,TC26,30760,30,30000,760
14358142,44942,TC26,30960,32,32000,-1040
14492164,44992,TC20,5000,,5000,0
14492164,44992,TC20,5000,5,5000,0
14385878,44952,TC26,29940,30,30000,-60
14331626,44931,TC26,33040,34,34000,-960
14509567,45009,TC26,31800,31,31000,800
14401617,44959,TC26,30940,,30940,0
14401617,44959,TC26,30940,,30940,0
14401617,44959,TC26,30940,,30940,0
14483952,44998,TC20,32170,32,32000,170
14361498,44943,TC26,30640,30,30000,640
14398532,44958,TC26,30940,31,31000,-60
14512741,45006,TC26,30920,30,30000,920
14391548,44953,TC26,30860,31,31000,-140
14450725,44979,TC26,30980,30,30000,980
14385885,44952,TC26,31020,31,31000,20
14392942,44956,TC26,30960,30,30000,960
14519334,45008,TC20,32170,32,32000,170
14501576,45001,TC26,31920,31,31000,920
14509564,45005,TC25,30280,30,30000,280
14361497,44943,TC25,29880,30,30000,-120
14462593,44985,TC25,30000,30,30000,0
14473475,44991,TC20,31030,31,31000,30
14512743,45005,TC26,29680,30,30000,-320
14516753,45007,TC20,26940,26,26000,940
14426865,44970,TC20,26940,26,26000,940
14452464,44979,CON40,28000,28,28000,0
14356951,44943,CON40,29000,29,29000,0
14397760,44957,CON40,4000,4,4000,0
14397760,44957,CON40,4000,,4000,0
14455849,44979,TC40,29600,29,29000,600
14472240,44986,TC40,30600,30,30000,600
14426924,44970,TC40,31440,31,31000,440
14386604,44952,CON40,32000,32,32000,0
14472256,44988,TC40,30600,31,31000,-400
14453033,44978,TC40,27600,27,27000,600
14491139,44995,TC40,30600,30,30000,600
14333055,44931,TC40,34000,29,29000,5000
14333055,44931,TC40,34000,,34000,0
14333055,44931,TC40,34000,,34000,0
14520420,45007,TC40,30600,30,30000,600
14456927,44980,TC40,28080,28,28000,80
14409099,44964,TC40,30600,30,30000,600
14455850,44980,TC40,26600,26,26000,600
14440123,44973,TC40,30600,30,30000,600
14405132,44960,TC40,26600,26,26000,600
14482535,44995,TC40,29600,29,29000,600
14400279,44958,TC40,34000,31,31000,3000
14482517,44992,TC40,26600,27,27000,-400
14434658,44972,TC40,30600,30,30000,600
14406057,44960,TC40,30600,30,30000,600
14375539,44950,CON40,28000,27,27000,1000
14401412,44959,CON20,2000,4,4000,-2000
14357779,44943,CON40,29000,24,24000,5000
14419484,44965,CON40,25000,24,24000,1000
14407777,44964,CON40,28000,24,24000,4000
14323291,44928,CON30,4000,3,3000,1000
14362762,44942,CON30,35000,32,32000,3000
14442381,44973,CON30,35000,31,31000,4000
14469001,44985,CON30,4000,4,4000,0
14426263,44970,CON30,4000,4,4000,0
14366839,44943,CON30,35000,31,31000,4000
14348342,44936,CON30,35000,32,32000,3000
14537497,45009,CON30,22000,,22000,0
14537497,45009,CON30,22000,,22000,0
14531412,45008,TC20,5000,4,4000,1000
14507939,44998,CON20,2000,,2000,0
14507939,44998,CON20,2000,2,2000,0
14507939,44998,CON20,2000,,2000,0
14507939,44998,CON20,2000,2,2000,0
14482384,44992,TC20,5000,5,5000,0
14413951,44963,TC20,5000,5,5000,0
14519989,45005,TC30,6000,6,6000,0
14328134,44931,TC20,5000,3,3000,2000
14356691,44945,TC20,5000,5,5000,0
14525094,45007,TC30,6000,6,6000,0
14355385,44942,TC30,6000,5,5000,1000
14413950,44965,TC20,5000,4,4000,1000
14436434,44973,TC20,24960,24,24000,960
14389586,44957,TC20,21000,30,30000,-9000
14384033,44951,TC20,20000,20,20000,0
14381221,44952,TC20,5000,5,5000,0
14407761,44964,TC20,33000,30,30000,3000
14426374,44973,TC20,5000,4,4000,1000
14465379,44984,TC20,5000,5,5000,0
14405474,44959,TC20,5000,5,5000,0
14463964,44985,TC20,33000,32,32000,1000
14510254,45006,TC20,5000,5,5000,0
14440364,44976,TC20,18910,20,20000,-1090
14384116,44952,TC20,25000,25,25000,0
14521075,45005,TC20,5000,5,5000,0
14469470,44985,TC20,5000,4,4000,1000
14469470,44985,TC20,5000,,5000,0
14529693,45008,TC20,5000,5,5000,0
14461013,44981,TC20,5000,5,5000,0
14389199,44957,TC20,25000,25,25000,0
14498057,45005,TC20,5000,5,5000,0
14328391,44930,TC20,25000,25,25000,0
14389193,44953,TC20,25000,25,25000,0
14374487,44950,TC20,5000,,5000,0
14374487,44950,TC20,5000,5,5000,0
14435722,44971,TC20,5000,5,5000,0
14427473,44969,TC20,29180,29,29000,180
14386664,44952,TC26,28120,30,30000,-1880
14355742,44939,TC26,29000,29,29000,0
14355742,44939,TC26,29000,,29000,0
14400450,44960,TC26,29000,30,30000,-1000
14355115,44942,TC20,29180,,29180,0
14520075,45006,TC20,5000,5,5000,0
14328151,44928,TC26,30000,30,30000,0
14363129,44944,TC26,30000,30,30000,0
14408984,44963,TC26,30000,30,30000,0
14380693,44951,TC26,29000,29,29000,0
14516616,45005,TC26,30000,30,30000,0
14493527,44995,TC26,30000,30,30000,0
14443591,44974,TC26,29000,29,29000,0
14465290,44985,TC26,30880,30,30000,880
14349054,44939,TC30,6000,6,6000,0
14332519,44935,TC20,29180,,29180,0
14332519,44935,TC20,29180,29,29000,180
14332519,44935,TC20,29180,,29180,0
14345591,44936,TC20,29180,,29180,0
14447223,44978,TC20,29180,30,30000,-820
14414909,44966,TC20,29180,30,30000,-820
14339708,44935,TC20,0,5,5000,-5000
14351381,44938,TC26,30000,30,30000,0
14400159,44959,TC26,29000,29,29000,0
14376096,44949,TC26,30000,30,30000,0
14427240,44970,TC26,33000,28,28000,5000
14464835,44983,TC26,15000,15,15000,0
14464835,44983,TC26,15000,,15000,0
14400076,44960,TC20,29140,29,29000,140
14368217,44949,TC26,30000,30,30000,0
14481885,44993,TC26,29700,30,30000,-300
14525540,45007,TC26,29980,30,30000,-20
14358226,44943,TC20,29140,29,29000,140
14330954,44936,TC26,30000,28,28000,2000
14440051,44976,TC20,19140,20,20000,-860
14475392,44990,TC20,29140,29,29000,140
14358225,44943,TC20,29140,30,30000,-860
14341693,44935,TC26,30000,30,30000,0
14476892,44988,TC20,5000,4,4000,1000
14351749,44939,TC20,32520,32,32000,520
14476901,44987,TC26,28940,28,28000,940
14452970,44980,TC26,28200,28,28000,200
14496864,45002,TC26,30000,30,30000,0
14514922,45002,TC26,30000,30,30000,0
14365723,44946,TC20,29020,29,29000,20
14475391,44990,TC20,29000,30,30000,-1000
14352361,44939,TC26,30000,30,30000,0
14380173,44950,TC26,10000,10,10000,0
14332591,44931,TC20,29020,,29020,0
14332591,44931,TC20,29020,,29020,0
14473047,44986,TC26,30020,30,30000,20
14444331,44977,TC26,30000,5,5000,25000
14427143,44969,TC26,30000,31,31000,-1000
14506865,44999,TC26,30000,30,30000,0
14389577,44955,TC20,29020,30,30000,-980
14330165,44931,TC20,32020,32,32000,20
14330165,44931,TC20,32020,,32020,0
14389576,44955,TC20,29020,30,30000,-980
14525592,45008,TC20,28000,,28000,0
14433463,44971,TC20,12000,12,12000,0
14386673,44953,TC26,30000,30,30000,0
14409606,44963,TC26,25000,25,25000,0
14531016,45009,TC26,30000,30,30000,0
14365724,44945,TC20,29020,30,30000,-980
14351385,44938,TC26,29000,29,29000,0
14355283,44942,TC20,28180,30,30000,-1820
14328476,44929,TC26,30000,30,30000,0
14355285,44940,TC20,28180,30,30000,-1820
14331801,44936,CON30,4000,4,4000,0
14416571,44970,CON30,4000,4,4000,0
14326501,44928,CON30,35000,30,30000,5000
14370505,44953,CON30,4000,4,4000,0
14330166,44931,CON30HC,4000,4,4000,0
14339728,44942,CON30,4000,3,3000,1000
14468621,44984,CON30,3000,5,5000,-2000
14498055,44998,TC30,28000,,28000,0
14498055,44998,TC30,28000,,28000,0
14498055,44998,TC30,28000,29,29000,-1000
14331990,44939,CON30,4000,4,4000,0
14482459,44991,TC30,30000,30,30000,0
14370504,44958,CON30,4000,4,4000,0
14404670,44966,CON30,4000,4,4000,0
14503181,45002,CON30,4000,4,4000,0
14453534,44979,TC30,34000,30,30000,4000
14437853,44978,CON30,4000,4,4000,0
14482455,44991,TC30,30000,30,30000,0
14490729,44994,CON30,25000,30,30000,-5000
14416584,44970,CON30,4000,4,4000,0
14488285,44991,CON30,3000,,3000,0
14488285,44991,CON30,3000,2,2000,1000
14488285,44991,CON30,3000,2,2000,1000
14516655,45008,CON30,4000,4,4000,0
14347322,44945,CON30,4000,3,3000,1000
14347322,44945,CON30,4000,,4000,0
14426253,44973,CON30,4000,4,4000,0
14474117,44986,TC30,37000,30,30000,7000
14498052,44998,TC30,28000,29,29000,-1000
14498052,44998,TC30,28000,,28000,0
14503061,45005,CON30,4000,4,4000,0
14452383,44978,CON30,27000,30,30000,-3000
14357554,44942,CON30,4000,3,3000,1000
14474313,44991,CON30,4000,4,4000,0
14452059,44977,CON30,31000,26,26000,5000
14442327,44988,CON30,4000,4,4000,0
14397720,44960,CON30,4000,3,3000,1000
14380495,44953,CON30,4000,4,4000,0
14361488,44945,CON30,4000,4,4000,0
14445507,44986,CON30,4000,4,4000,0
14516919,45006,TC30,31000,30,30000,1000
14453538,44979,TC30,37000,28,28000,9000
14498049,44998,TC30,28000,28,28000,0
14442703,44980,CON30,4000,4,4000,0
14351094,44938,CON30,35000,32,32000,3000
14416585,44970,CON30,4000,4,4000,0
14516923,45006,TC30,31000,30,30000,1000
14397653,44960,CON30,4000,4,4000,0
14461392,44981,TC30,6000,,6000,0
14461392,44981,TC30,6000,5,5000,1000
14461392,44981,TC30,6000,,6000,0
14400079,44960,CON30HC,4000,4,4000,0
14487502,44992,CON30,28000,,28000,0
14487502,44992,CON30,28000,30,30000,-2000
14482458,44991,TC30,30000,30,30000,0
14328725,44937,CON30HC,4000,2,2000,2000
14349121,44939,CON30,4000,4,4000,0
14312844,44935,CON30,4000,,4000,0
14474119,44986,CON30,31000,28,28000,3000
14498056,45005,CON30HC,4000,4,4000,0
14388372,44963,CON30,4000,3,3000,1000
14492019,45002,CON30HC,4000,3,3000,1000
14445481,44978,TC30,36000,29,29000,7000
14516917,45006,CON30,28000,30,30000,-2000
14380490,44950,CON30HC,4000,4,4000,0
14354064,44943,CON30,4000,4,4000,0
14454999,44979,TC30,9000,3,3000,6000
14426256,44972,CON30,4000,3,3000,1000
14516922,45006,CON30,28000,30,30000,-2000
14490326,44992,CON30,28000,30,30000,-2000
14312842,44930,CON30,4000,3,3000,1000
14416572,44970,CON30,4000,5,5000,-1000
14468614,44985,TC30,30000,28,28000,2000
14444197,44974,CON30,3000,2,2000,1000
14444197,44974,CON30,3000,,3000,0
14444197,44974,CON30,3000,,3000,0
14507347,44998,TC30,6000,,6000,0
14507347,44998,TC30,6000,2,2000,4000
14479383,44994,CON30,4000,4,4000,0
14416570,44970,CON30,4000,3,3000,1000
14446277,44979,CON30,4000,4,4000,0
14489857,44992,TC30,31000,30,30000,1000
14397719,44960,CON30,4000,3,3000,1000
14475039,44987,TC30,37000,30,30000,7000
14413782,44967,CON30,4000,4,4000,0
14380489,44952,CON30,4000,3,3000,1000
14439771,44972,CON30,3000,2,2000,1000
14347901,44938,CON30,31860,3,3000,28860
14482471,44991,TC30,30000,30,30000,0
14355381,44946,CON30,4000,4,4000,0
14490472,44993,CON30,25000,,25000,0
14490472,44993,CON30,25000,,25000,0
14490472,44993,CON30,25000,30,30000,-5000
14490713,44994,TC30,28000,,28000,0
14509759,45000,TC30,28000,,28000,0
14509759,45000,TC30,28000,31,31000,-3000
14397741,44963,CON30,4000,4,4000,0
14444125,44977,TC30,34000,29,29000,5000
14444125,44977,TC30,34000,,34000,0
14397718,44960,CON30,4000,4,4000,0
14538316,45009,TC30,6000,,6000,0
14475040,44987,CON30,34000,30,30000,4000
14532235,45007,TC30,6000,,6000,0
14487495,44992,CON30,28000,31,31000,-3000
14493901,44993,CON30HC,26000,,26000,0
14493901,44993,CON30HC,26000,2,2000,24000
14339777,44938,CON30,4000,3,3000,1000
14487234,45001,CON30HC,4000,4,4000,0
14361490,44949,CON30,4000,3,3000,1000
14487471,44992,CON30,28000,30,30000,-2000
14476941,45002,CON30,4000,,4000,0
14476941,45002,CON30,4000,3,3000,1000
14450563,44977,CON30,27000,27,27000,0
14306693,44935,CON30,4000,4,4000,0
14441126,44988,CON30HC,4000,4,4000,0
14325046,44929,CON30,4000,4,4000,0
14471268,44985,TC30,31000,30,30000,1000
14382476,44956,CON30,4000,4,4000,0
14478829,44994,CON30,4000,4,4000,0
14440060,44974,CON30,31000,28,28000,3000
14536987,45009,TC30,30000,30,30000,0
14536987,45009,TC30,30000,29,29000,1000
14487468,44992,CON30,25000,30,30000,-5000
14407585,44966,CON30,4000,4,4000,0
14336339,44936,CON30,4000,4,4000,0
14437854,44979,CON30,4000,4,4000,0
14490437,44993,TC30,28000,,28000,0
14490437,44993,TC30,28000,,28000,0
14490437,44993,TC30,28000,29,29000,-1000
14490437,44993,TC30,28000,30,30000,-2000
14347904,44938,CON30,4000,4,4000,0
14453532,44979,TC30,34000,30,30000,4000
14434178,44971,TC30,9000,2,2000,7000
14406174,44959,CON30HC,6000,3,3000,3000
14391927,44958,CON30,4000,4,4000,0
14440063,44974,CON30,31000,27,27000,4000
14471666,44988,CON30,4000,4,4000,0
14524040,45005,CON30HC,3000,3,3000,0
14524040,45005,CON30HC,3000,,3000,0
14492021,45002,CON30,4000,4,4000,0
14503063,45005,CON30,4000,4,4000,0
14471264,44985,TC30,30000,28,28000,2000
14402708,44966,CON30,4000,5,5000,-1000
14516913,45006,CON30HC,28000,30,30000,-2000
14372035,44956,CON30,4000,4,4000,0
14488682,45001,CON30HC,4000,3,3000,1000
14453536,44979,TC30,34000,30,30000,4000
14494862,44994,CON30,3000,3,3000,0
14487235,45000,CON30HC,4000,4,4000,0
14452430,44977,CON30,3000,3,3000,0
14383438,44957,CON30,4000,4,4000,0
14476796,44986,CON30,3000,3,3000,0
14451559,44981,CON30,4000,4,4000,0
14379943,44950,CON30,35000,32,32000,3000
14423103,44973,CON30,4000,4,4000,0
14331802,44936,CON30,4000,4,4000,0
14331800,44935,CON30,4000,4,4000,0
14473241,44998,CON30,4000,4,4000,0
14413784,44979,CON30,4000,4,4000,0
14385605,44951,CON30,36000,31,31000,5000
14339735,44938,CON30,4000,3,3000,1000
14451561,44981,CON30,4000,5,5000,-1000
14437852,44978,CON30,4000,4,4000,0
14329772,44929,CON30,31000,29,29000,2000
14370507,44953,CON30,4000,4,4000,0
14370506,44953,CON30,4000,4,4000,0
14329767,44929,CON30,35000,30,30000,5000
14379981,44950,CON30,35000,33,33000,2000
14413780,44967,CON30,4000,4,4000,0
14492020,45002,CON30,4000,4,4000,0
14374560,44952,CON30,4000,4,4000,0
14329775,44929,CON30,35000,30,30000,5000
14371998,44956,CON30,4000,3,3000,1000
14325569,44928,CON30,4000,3,3000,1000
14502833,45001,CON30,31200,30,30000,1200
14347324,44945,CON30,4000,4,4000,0
14331813,44935,CON30,4000,4,4000,0
14330167,44931,CON30HC,4000,4,4000,0
14330167,44931,CON30HC,4000,,4000,0
14351768,44938,CON30,31860,31,31000,860
14385604,44951,CON30,34000,31,31000,3000
14413781,44979,CON30,4000,4,4000,0
14351059,44945,CON30,4000,4,4000,0
14417052,44973,CON30,4000,4,4000,0
14354309,44942,CON30,4000,4,4000,0
14370508,44953,CON30,4000,4,4000,0
14337919,44931,CON30,35000,32,32000,3000
14330168,44931,CON30HC,4000,4,4000,0
14460809,44980,CON30,31860,32,32000,-140
14347323,44945,CON30,4000,,4000,0
14347323,44945,CON30,4000,3,3000,1000
14473529,44986,CON30HC,4000,4,4000,0
14487233,45001,CON30HC,4000,4,4000,0
14472242,44986,CON30,4000,4,4000,0
14361495,44951,CON30,4000,4,4000,0
14396444,44974,CON30,4000,4,4000,0
14434847,44985,CON30,4000,4,4000,0
14458620,44988,CON30,4000,4,4000,0
14332006,44937,CON30,4000,3,3000,1000
14380070,44957,CON30,4000,4,4000,0
14493085,44999,CON30,4000,4,4000,0
14516275,45006,CON30,4000,4,4000,0
14434850,44986,CON30,4000,4,4000,0
14361494,44945,CON30,4000,4,4000,0
14502061,45000,CON30,4000,4,4000,0
14380069,44956,CON30,4000,3,3000,1000
14396604,44967,CON30,4000,4,4000,0
14475764,44988,CON30,4000,3,3000,1000
14475764,44988,CON30,4000,,4000,0
14437692,44987,CON30,4000,4,4000,0
14417027,44977,CON30,4000,4,4000,0
14380068,44953,CON30,4000,4,4000,0
14436301,44981,CON30,4000,4,4000,0
14417083,44979,CON30,4000,3,3000,1000
14396441,44963,CON30,4000,4,4000,0
14396443,44973,CON30,4000,4,4000,0
14507869,45001,CON30,4000,4,4000,0
14458623,44993,CON30,4000,4,4000,0
14361707,44950,CON30,4000,4,4000,0
14479093,44989,CON30,4000,4,4000,0
14471602,44991,CON30,4000,4,4000,0
14361493,44949,CON30,4000,4,4000,0
14434848,44985,CON30,4000,3,3000,1000
14498855,45000,CON30,4000,4,4000,0
14479092,44988,CON30,4000,4,4000,0
14328660,44930,CON30,4000,3,3000,1000
14352534,44939,CON30,4000,5,5000,-1000
14409082,44963,CON30,4000,3,3000,1000
14461483,44985,CON30,4000,4,4000,0
14465363,44988,CON30,4000,4,4000,0
14442504,44977,CON30,4000,4,4000,0
14390066,44959,CON30,4000,4,4000,0
14339480,44939,CON30,4000,4,4000,0
14517175,45002,CON30,4000,4,4000,0
14491853,44993,CON30,4000,4,4000,0
14460640,44985,CON30,4000,4,4000,0
14347902,44937,CON30,4000,4,4000,0
14407801,44966,CON30,4000,4,4000,0
14479971,44988,CON30,4000,3,3000,1000
14511707,45006,CON30,4000,4,4000,0
14362138,44944,CON30HC,4000,4,4000,0
14473218,44993,CON30HC,4000,4,4000,0
14527775,45006,CON30HC,4000,4,4000,0
14345525,44939,CON30HC,31860,4,4000,27860
14408507,44963,CON30HC,4000,3,3000,1000
14333125,44931,CON30HC,4000,4,4000,0
14366712,44944,CON30HC,4000,4,4000,0
14492132,44995,CON30HC,4000,4,4000,0
14490715,44993,CON30HC,4000,4,4000,0
14534673,45009,CON30HC,4000,4,4000,0
14346411,44937,CON30HC,4000,3,3000,1000
14509593,45001,CON30HC,4000,4,4000,0
14496738,45000,CON30HC,4000,4,4000,0
14475727,44988,CON30HC,4000,4,4000,0
14495078,44994,CON30HC,4000,4,4000,0
14480001,44993,CON30HC,4000,4,4000,0
14527774,45006,CON30HC,4000,4,4000,0
14527829,45007,CON30HC,4000,4,4000,0
14482965,44998,CON30HC,4000,4,4000,0
14443650,44979,CON30,4000,4,4000,0
14527915,45008,CON30HC,4000,3,3000,1000
14477842,44995,CON30HC,4000,4,4000,0
14479963,44993,CON30HC,4000,4,4000,0
14521246,45005,CON30HC,4000,4,4000,0
14520538,45006,CON30HC,4000,4,4000,0
14470319,44985,CON30HC,29100,30,30000,-900
14488447,45008,CON30HC,4000,4,4000,0
14347610,44938,CON30,4000,4,4000,0
14365812,44949,CON30HC,4000,4,4000,0
14479965,44992,CON30HC,4000,4,4000,0
14491201,44995,CON30HC,4000,4,4000,0
14535230,45008,CON30HC,4000,4,4000,0
14440053,44974,CON30HC,4000,4,4000,0
14427301,44973,CON30HC,4000,4,4000,0
14479794,44988,CON30HC,4000,3,3000,1000
14427224,44972,CON30HC,4000,4,4000,0
14529171,45009,CON30HC,4000,,4000,0
14340059,44935,CON30HC,4000,3,3000,1000
14386331,44952,CON30,4000,4,4000,0
14477888,44992,CON30HC,4000,4,4000,0
14487368,44993,CON30HC,4000,3,3000,1000
14354065,44938,CON30HC,4000,3,3000,1000
14340756,44939,CON30,31430,30,30000,1430
14510630,45000,CON30HC,4000,4,4000,0
14509592,45001,CON30HC,4000,4,4000,0
14492133,44998,CON30HC,4000,4,4000,0
14380469,44951,CON30,3000,4,4000,-1000
14487371,44993,CON30HC,4000,4,4000,0
14447030,44977,CON30HC,4000,5,5000,-1000
14527920,45007,CON30HC,4000,3,3000,1000
14529765,45007,CON30HC,4000,5,5000,-1000
14491920,44993,CON30HC,4000,4,4000,0
14347893,44939,CON30HC,4000,4,4000,0
14345876,44937,CON30HC,31860,31,31000,860
14491200,45000,CON30HC,4000,4,4000,0
14409098,44964,CON30HC,4000,4,4000,0
14355467,44945,CON30HC,4000,4,4000,0
14361491,44949,CON30HC,4000,4,4000,0
14517179,45002,CON30HC,4000,3,3000,1000
14481947,44991,CON30HC,4000,4,4000,0
14345526,44937,CON30HC,31860,4,4000,27860
14375783,44950,CON30,31430,30,30000,1430
14353443,44945,CON30HC,4000,4,4000,0
14520631,45005,CON30HC,4000,4,4000,0
14527914,45007,CON30HC,4000,3,3000,1000
14479966,44992,CON30HC,4000,4,4000,0
14340753,44937,CON30,31430,30,30000,1430
14347894,44943,CON30HC,4000,4,4000,0
14331126,44931,CON30,31430,31,31000,430
14491997,44999,CON30HC,4000,4,4000,0
14375782,44951,CON30,31430,30,30000,1430
14423473,44967,CON30HC,4000,4,4000,0
14333124,44937,CON30HC,4000,,4000,0
14333124,44937,CON30HC,4000,3,3000,1000
14527913,45007,CON30HC,4000,4,4000,0
14475070,44987,CON30HC,4000,4,4000,0
14516297,45002,CON30HC,4000,4,4000,0
14331127,44931,CON30,31100,30,30000,1100
14332834,44935,CON30HC,4000,4,4000,0
14469327,44987,CON30HC,4000,4,4000,0
14517299,45007,CON30HC,4000,4,4000,0
14509783,44999,CON30HC,4000,4,4000,0
14326624,44929,CON30HC,4000,4,4000,0
14422946,44970,CON30HC,4000,4,4000,0
14520656,45005,CON30HC,4000,4,4000,0
14481782,44993,CON30HC,4000,4,4000,0
14345873,44951,CON30HC,4000,4,4000,0
14340754,44939,CON30,31860,31,31000,860
14361706,44944,CON30HC,4000,4,4000,0
14502911,44998,CON30HC,4000,4,4000,0
14527833,45006,CON30HC,4000,4,4000,0
14502834,45005,CON30,31860,32,32000,-140
14433844,44971,CON30HC,4000,5,5000,-1000
14427294,44971,CON30HC,4000,4,4000,0
14532759,45008,CON30HC,4000,3,3000,1000
14479815,44988,CON30HC,4000,5,5000,-1000
14340755,44936,CON30,31860,31,31000,860
14491986,44994,CON30HC,4000,3,3000,1000
14520659,45006,CON30HC,4000,4,4000,0
14417112,44964,CON30HC,4000,4,4000,0
14473217,44992,CON30HC,4000,4,4000,0
14520657,45006,CON30HC,4000,4,4000,0
14491987,44994,CON30HC,4000,4,4000,0
14427225,44970,CON30HC,4000,3,3000,1000
14353414,44944,CON30HC,4000,4,4000,0
14345528,44938,CON30HC,4000,4,4000,0
14517168,45004,CON30HC,4000,4,4000,0
14491995,44994,CON30HC,4000,3,3000,1000
14491996,45001,CON30HC,4000,4,4000,0
14413873,44965,CON30HC,4000,3,3000,1000
14498414,44998,CON30HC,4000,4,4000,0
14320015,44928,CON30HC,4000,4,4000,0
14351452,44937,CON30,31860,31,31000,860
14529172,45008,CON30HC,4000,4,4000,0
14442323,44973,CON30HC,4000,4,4000,0
14479964,44988,CON30HC,4000,4,4000,0
14379741,44950,CON30,4000,4,4000,0
14427343,44974,CON30HC,4000,4,4000,0
14483354,44991,CON30HC,4000,4,4000,0
14364941,44949,CON30HC,4000,4,4000,0
14482533,44991,CON30HC,4000,4,4000,0
14481783,44991,CON30HC,4000,4,4000,0
14437543,44972,CON30HC,4000,4,4000,0
14490714,44992,CON30HC,4000,4,4000,0
14419481,44965,CON30HC,4000,3,3000,1000
14508451,44999,CON30HC,4000,3,3000,1000
14517151,45002,CON30HC,4000,4,4000,0
14433843,44971,CON30HC,4000,4,4000,0
14473231,44991,CON30HC,4000,4,4000,0
14346107,44936,CON40,4000,3,3000,1000
14363021,44949,CON40,4000,4,4000,0
14408675,44966,CON40,4000,4,4000,0
14502915,45001,CON40,4000,4,4000,0
14488670,44992,TC40,7000,4,4000,3000
14463907,44981,CON40,4000,5,5000,-1000
14352483,44949,CON40,30000,29,29000,1000
14340173,44939,CON40,4000,4,4000,0
14380998,44957,CON40,29000,26,26000,3000
14427352,44971,CON40,4000,,4000,0
14488657,44994,CON40,4000,3,3000,1000
14517166,45006,CON40,4000,4,4000,0
14436118,44977,CON40,4000,4,4000,0
14527835,45007,CON40,4000,4,4000,0
14397322,44963,CON40,4000,4,4000,0
14347770,44944,CON40,4000,4,4000,0
14516306,45002,CON40,4000,3,3000,1000
14491912,44998,CON40,4000,4,4000,0
14337592,44935,CON40,4000,4,4000,0
14417000,44966,TC40,7000,7,7000,0
14496822,45002,CON40,4000,4,4000,0
14509594,45001,CON40,4000,4,4000,0
14382915,44958,CON40,30000,30,30000,0
14306913,44928,CON40,4000,4,4000,0
14382916,44958,CON40,30000,28,28000,2000
14517164,45005,CON40,4000,4,4000,0
14352428,44938,CON40,4000,4,4000,0
14519998,45009,TC40,32000,28,28000,4000
14446404,44981,CON40,4000,4,4000,0
14306912,44929,CON40,4000,3,3000,1000
14389913,44953,CON40,4000,4,4000,0
14392143,44956,CON40,4000,4,4000,0
14357414,44939,CON40,4000,4,4000,0
14457532,44985,CON40,30000,30,30000,0
14375950,44953,CON40,4000,4,4000,0
14506428,45000,CON40,31860,4,4000,27860
14469843,44988,TC40,32000,32,32000,0
14478774,44994,CON40,4000,3,3000,1000
14345874,44936,CON40,4000,3,3000,1000
14392559,44958,CON40,4000,4,4000,0
14392559,44958,CON40,4000,,4000,0
14488101,44998,CON40,29000,30,30000,-1000
14324794,44928,CON40,4000,4,4000,0
14376158,44950,CON40,4000,4,4000,0
14399358,44960,CON40,4000,4,4000,0
14491828,45007,CON40,4000,4,4000,0
14517167,45006,CON40,4000,4,4000,0
14469490,44985,CON40,4000,5,5000,-1000
14436693,44972,CON40,4000,3,3000,1000
14472339,44986,CON40,4000,4,4000,0
14453824,44979,TC40,7000,4,4000,3000
14491743,44992,TC40,7000,7,7000,0
14333007,44936,CON40,30000,30,30000,0
14380775,44956,CON40,30000,30,30000,0
14313831,44929,CON40,4000,4,4000,0
14357579,44942,CON40,4000,4,4000,0
14396930,44959,CON40,4000,4,4000,0
14417387,44971,CON40,30000,30,30000,0
14346155,44937,CON40,4000,3,3000,1000
14480843,44991,CON40,4000,4,4000,0
14453825,44979,TC40,7000,4,4000,3000
14469486,44985,TC40,7000,4,4000,3000
14498415,44999,TC40,8000,4,4000,4000
14417001,44965,TC40,7000,7,7000,0
14357973,44943,CON30,4000,,4000,0
14357973,44943,CON30,4000,3,3000,1000
14421454,44966,CON40,4000,4,4000,0
14491266,44998,CON40,30000,30,30000,0
14464555,44987,TC20,5000,4,4000,1000
14408461,44960,TC20,5000,3,3000,2000
14388476,44953,TC20,5000,5,5000,0
14461552,44980,TC20,5000,4,4000,1000
14387480,44952,TC20,5000,4,4000,1000
14387478,44952,TC20,5000,5,5000,0
14388475,44953,TC20,5000,5,5000,0
14461561,44980,TC20,5000,5,5000,0
14461565,44980,TC20,5000,5,5000,0
14465422,44984,TC20,5000,5,5000,0
14382462,44950,TC26,35000,30,30000,5000
14501996,44995,TC20,30000,,30000,0
14501996,44995,TC20,30000,30,30000,0
14368049,44944,TC20,34000,,34000,0
14368049,44944,TC20,34000,28,28000,6000
14336489,44935,TC20,34000,28,28000,6000
14336489,44935,TC20,34000,,34000,0
14370668,44946,TC20,34000,,34000,0
14370668,44946,TC20,34000,28,28000,6000
14370668,44946,TC20,34000,,34000,0
14370668,44946,TC20,34000,,34000,0
14327864,44928,TC20,33000,28,28000,5000
14327864,44928,TC20,33000,,33000,0
14327853,44928,TC20,34000,30,30000,4000
14370671,44946,TC20,34000,,34000,0
14370671,44946,TC20,34000,28,28000,6000
14370671,44946,TC20,34000,,34000,0
14370671,44946,TC20,34000,,34000,0
14470464,44988,TC20,5000,4,4000,1000
14490406,44993,TC20,5000,4,4000,1000
14384380,44956,TC20,5000,5,5000,0
14384380,44956,TC20,5000,,5000,0
14399334,44960,TC20,5000,4,4000,1000
14363299,44944,TC20,5000,5,5000,0
14446068,44981,TC20,5000,5,5000,0
14339663,44935,TC20,5000,5,5000,0
14351688,44939,TC20,5000,5,5000,0
14524514,45009,TC20,5000,5,5000,0
14433638,44972,TC20,5000,4,4000,1000
14433638,44972,TC20,5000,,5000,0
14327890,44928,TC20,5000,5,5000,0
14510184,45005,TC20,5000,4,4000,1000
14403335,44967,TC20,5000,5,5000,0
14375681,44951,TC20,5000,4,4000,1000
14509192,44999,TC20,27300,27,27000,300
14358025,44944,TC23,30000,30,30000,0
14502762,45000,TC23,25251,25,25000,251
14376259,44949,TC20,31300,26,26000,5300
14375058,44950,TC26,32300,27,27000,5300
14463589,44981,TC20,27300,28,28000,-700
14390943,44953,TC20,31500,26,26000,5500
14327474,44929,TC20,20500,20,20000,500
14327475,44929,TC20,24470,24,24000,470
14400151,44958,TC20,34470,28,28000,6470
14401910,44960,TC23,30500,30,30000,500
14426360,44970,TC23,33000,33,33000,0
14446069,44978,TC26,23780,25,25000,-1220
14510180,45001,TC26,31820,31,31000,820
14506439,45000,TC26,36240,32,32000,4240
14370548,44945,TC26,26033,26,26000,33
14372230,44946,TC26,26000,26,26000,0
14357983,44943,TC20,25000,26,26000,-1000
14425686,44967,TC20,26000,26,26000,0
14490389,44993,TC26,25000,26,26000,-1000
14469595,44988,TC26,30500,30,30000,500
14387369,44952,TC25,30020,30,30000,20
14437865,44972,TC25,30000,30,30000,0
14357901,44943,TC20,25000,25,25000,0
14455040,44995,TC25,26034,26,26000,34
14352605,44942,TC26,32500,30,30000,2500
14340778,44936,TC26,5000,28,28000,-23000
14446309,44980,TC26,25924,26,26000,-76
14439682,44973,TC26,30060,30,30000,60
14506442,45000,TC26,32000,32,32000,0
14339538,44937,TC20,25550,26,26000,-450
14514846,45002,TC26,32000,32,32000,0
14439683,44973,TC26,30000,30,30000,0
14478714,44992,TC26,24530,24,24000,530
14506437,44999,TC26,31860,32,32000,-140
14434240,44973,TC26,25900,26,26000,-100
14457777,44981,TC26,32000,33,33000,-1000
14414765,44964,TC26,27550,,27550,0
14502010,44995,TC25,30000,27,27000,3000
14502010,44995,TC25,30000,,30000,0
14413496,44966,TC26,26000,26,26000,0
14439679,44974,TC26,30300,30,30000,300
14510181,45000,TC26,31900,32,32000,-100
14437864,44972,TC26,30400,30,30000,400
14495972,44994,TC20,6000,3,3000,3000
14497161,44998,TC26,32000,32,32000,0
14413491,44965,TC26,25952,26,26000,-48
14413490,44965,TC26,30155,30,30000,155
14434504,44973,TC26,26000,26,26000,0
14439681,44974,TC26,30300,30,30000,300
14339513,44937,TC20,25210,26,26000,-790
14401958,44958,TRA,23000,19,19000,4000
14422478,44971,CON30,4000,3,3000,1000
14514037,45005,CON30,4000,4,4000,0
14419935,44966,CON30,4000,4,4000,0
14496903,44999,CON30,4000,3,3000,1000
14514036,45005,CON30,4000,4,4000,0
14372126,44949,CON30,4000,4,4000,0
14514039,45005,CON30HC,4000,4,4000,0
14434635,44974,CON30,4000,4,4000,0
14482321,44993,CON30,4000,4,4000,0
14451556,44981,CON30,4000,4,4000,0
14328424,44936,CON30,4000,4,4000,0
14398940,44959,CON30,4000,4,4000,0
14364321,44949,CON30,29200,29,29000,200
14344589,44937,CON30,4000,3,3000,1000
14501819,44995,CON30,27000,26,26000,1000
14361198,44942,CON30,4000,4,4000,0
14491265,44995,CON30,4000,4,4000,0
14514035,45005,CON30,4000,4,4000,0
14516276,45002,CON30,4000,4,4000,0
14433079,44972,CON30,4000,4,4000,0
14491179,44994,CON30,4000,4,4000,0
14475130,44988,CON30,4000,4,4000,0
14375372,44953,CON30,29280,30,30000,-720
14441824,44977,CON30,4000,4,4000,0
14390710,44956,CON30,4000,4,4000,0
14387987,44956,CON30,4000,4,4000,0
14422477,44971,CON30,4000,5,5000,-1000
14469318,44987,CON30,4000,4,4000,0
14372128,44946,CON30,4000,4,4000,0
14375133,44949,CON30,32900,29,29000,3900
14394510,44960,CON30,4000,3,3000,1000
14341498,44936,CON30,4000,4,4000,0
14344592,44938,CON30,4000,4,4000,0
14404744,44959,CON30,25000,26,26000,-1000
14477844,44991,CON30,4000,4,4000,0
14392280,44957,CON30,4000,4,4000,0
14503441,45002,CON30,29900,30,30000,-100
14375787,44952,CON30,29280,30,30000,-720
14364254,44946,CON30,4000,4,4000,0
14506554,44998,CON30,22900,26,26000,-3100
14506554,44998,CON30,22900,,22900,0
14515727,45007,CON30,29280,30,30000,-720
14483951,44998,CON30,29280,29,29000,280
14490294,44994,CON30,4000,3,3000,1000
14478601,44991,CON30,4000,4,4000,0
14416318,44970,CON30,4000,4,4000,0
14362093,44946,CON30,29280,30,30000,-720
14348240,44937,CON30,4000,4,4000,0
14416312,44967,CON30,4000,3,3000,1000
14458588,44984,CON30,4000,3,3000,1000
14396398,44957,CON30,4000,4,4000,0
14524321,45005,CON30,28000,26,26000,2000
14397400,44958,CON30,4000,4,4000,0
14492581,44999,CON30,29280,30,30000,-720
14433475,44973,CON30,4000,4,4000,0
14422676,44971,CON30,4000,4,4000,0
14416922,44965,CON30,4000,3,3000,1000
14460279,44980,CON30,25000,25,25000,0
14337383,44931,CON30,4000,4,4000,0
14531125,45009,TC30,32000,29,29000,3000
14531125,45009,TC30,32000,,32000,0
14502059,44998,CON30,4000,4,4000,0
14488307,44991,CON30,22000,26,26000,-4000
14355291,44943,CON30,4000,3,3000,1000
14478600,44991,CON30,4000,4,4000,0
14344594,44937,CON30,4000,3,3000,1000
14444567,44978,CON30,4000,5,5000,-1000
14374645,44952,CON30,4000,4,4000,0
14491180,44994,CON30,4000,3,3000,1000
14344588,44938,CON30,4000,4,4000,0
14405183,44959,CON30,4000,4,4000,0
14496081,44998,CON30,4000,3,3000,1000
14375137,44949,CON30,34000,31,31000,3000
14394513,44960,CON30,4000,3,3000,1000
14457435,44979,TC30,33000,27,27000,6000
14465094,44985,CON30,4000,4,4000,0
14435435,44972,CON30,30880,30,30000,880
14355288,44943,CON30,4000,3,3000,1000
14399177,44959,CON30,29280,30,30000,-720
14408293,44965,CON30,4000,5,5000,-1000
14435974,44973,CON30,30880,30,30000,880
14526025,45008,CON30,4000,4,4000,0
14330947,44935,CON30,32200,29,29000,3200
14416315,44967,CON30,4000,4,4000,0
14527935,45009,CON30,4000,3,3000,1000
14528336,45006,CON30,31000,30,30000,1000
14521866,45009,CON30,29280,29,29000,280
14526023,45007,CON30,4000,4,4000,0
14398990,44960,CON30,4000,4,4000,0
14514041,45005,CON30,4000,4,4000,0
14477845,44991,CON30,4000,4,4000,0
14482322,44994,CON30,4000,4,4000,0
14372127,44949,CON30,4000,3,3000,1000
14333309,44935,CON30,4000,4,4000,0
14509133,45005,CON30,29280,29,29000,280
14444566,44978,CON30,4000,4,4000,0
14434395,44971,CON30,4000,4,4000,0
14374643,44950,CON30,4000,3,3000,1000
14443526,44977,CON30,4000,4,4000,0
14349343,44937,CON30,4000,4,4000,0
14496336,45004,CON30,4000,3,3000,1000
14364139,44945,CON30,4000,4,4000,0
14336527,44935,CON30,4000,4,4000,0
14382488,44950,CON30,34000,32,32000,2000
14333315,44935,CON30,4000,4,4000,0
14491264,44995,CON30,4000,4,4000,0
14509134,45005,CON30,29280,29,29000,280
14435986,44971,CON30,4000,5,5000,-1000
14380061,44951,CON30,4000,4,4000,0
14408294,44964,CON30,4000,4,4000,0
14451558,44980,CON30,4000,4,4000,0
14474288,44992,CON30,29280,30,30000,-720
14408296,44965,CON30,4000,4,4000,0
14325975,44929,CON30,29900,30,30000,-100
14347454,44936,CON30,28900,28,28000,900
14387942,44952,CON30,34000,32,32000,2000
14502269,44995,CON30,31000,,31000,0
14502269,44995,CON30,31000,32,32000,-1000
14502269,44995,CON30,31000,,31000,0
14496078,44999,CON30,4000,4,4000,0
14398941,44959,CON30,4000,4,4000,0
14526027,45007,CON30,4000,4,4000,0
14416574,44967,CON30,4000,5,5000,-1000
14454394,44980,CON30,29280,29,29000,280
14451557,44981,CON30,4000,4,4000,0
14345108,44935,CON30,4000,4,4000,0
14375366,44953,CON30,29280,30,30000,-720
14330413,44930,CON30,29280,30,30000,-720
14471459,44985,TC30,27000,27,27000,0
14416405,44964,CON30,31000,27,27000,4000
14435729,44972,CON30,4000,3,3000,1000
14463360,44987,CON30,29280,30,30000,-720
14364253,44946,CON30,4000,3,3000,1000
14396414,44958,CON30,4000,3,3000,1000
14519862,45002,CON30,24000,26,26000,-2000
14333310,44935,CON30,4000,4,4000,0
14451560,44980,CON30,4000,4,4000,0
14516285,45006,CON30,4000,4,4000,0
14469321,44988,CON30,4000,4,4000,0
14461377,44984,CON30,29280,29,29000,280
14356755,44943,CON30,29280,30,30000,-720
14382884,44951,CON30,4000,3,3000,1000
14490296,44994,CON30,4000,4,4000,0
14409305,44964,CON30,4000,4,4000,0
14375146,44949,CON30,34000,31,31000,3000
14394511,44960,CON30,4000,3,3000,1000
14435737,44974,CON30,4000,4,4000,0
14355287,44943,CON30,4000,4,4000,0
14439707,44972,CON30,23000,26,26000,-3000
14408002,44965,CON30,4000,3,3000,1000
14392308,44957,CON30,4000,4,4000,0
14397157,44957,CON30,29280,30,30000,-720
14476004,44986,TC30,28000,26,26000,2000
14396397,44960,CON30,4000,4,4000,0
14465095,44984,CON30,4000,4,4000,0
14325086,44929,CON30,4000,4,4000,0
14422335,44970,CON30,4000,5,5000,-1000
14434419,44972,CON30,4000,4,4000,0
14392870,44954,CON30,4000,4,4000,0
14396416,44958,CON30,4000,4,4000,0
14475131,44988,CON30,4000,5,5000,-1000
14512155,45007,CON30,29280,29,29000,280
14510207,44999,TC30,28000,26,26000,2000
14434634,44974,CON30,4000,5,5000,-1000
14531441,45007,CON30,31000,31,31000,0
14395647,44960,CON30,4000,4,4000,0
14380846,44949,CON30,33000,30,30000,3000
14399176,44960,CON30,29280,29,29000,280
14527806,45006,CON30,25000,25,25000,0
14492582,44999,CON30,29280,30,30000,-720
14353086,44942,CON30,4000,4,4000,0
14508436,45002,CON30,4000,3,3000,1000
14515725,45007,CON30,29280,30,30000,-720
14456683,44983,CON30,4000,4,4000,0
14516283,45007,CON30,4000,4,4000,0
14369380,44944,CON30,4000,4,4000,0
14379939,44951,CON30,4000,4,4000,0
14364255,44949,CON30,4000,4,4000,0
14482330,44993,CON30,4000,4,4000,0
14446516,44978,CON30,4000,4,4000,0
14482324,44994,CON30,4000,4,4000,0
14347474,44936,CON30,34000,29,29000,5000
14434396,44971,CON30,4000,4,4000,0
14469315,44987,CON30,4000,4,4000,0
14526026,45008,CON30,4000,4,4000,0
14478602,44991,CON30,4000,4,4000,0
14451577,44981,CON30,4000,4,4000,0
14519337,45008,CON30,29280,30,30000,-720
14397161,44958,CON30,29280,29,29000,280
14397161,44958,CON30,29280,,29280,0
14374621,44950,CON30,4000,4,4000,0
14422338,44970,CON30,4000,3,3000,1000
14399329,44957,CON30,30000,,30000,0
14399329,44957,CON30,30000,26,26000,4000
14462558,44986,CON30,29280,29,29000,280
14348914,44939,CON30,29280,29,29000,280
14519340,45008,CON30,29280,30,30000,-720
14439710,44972,CON30,4000,3,3000,1000
14344595,44937,CON30,4000,3,3000,1000
14396399,44957,CON30,4000,3,3000,1000
14516286,45008,CON30,4000,4,4000,0
14434397,44971,CON30,4000,3,3000,1000
14491199,45001,CON30,4000,4,4000,0
14374644,44950,CON30,4000,4,4000,0
14396395,44956,CON30,4000,4,4000,0
14456682,44980,CON30,4000,4,4000,0
14480020,44992,CON30,4000,4,4000,0
14496419,45005,CON30,29300,29,29000,300
14398989,44963,CON30,4000,4,4000,0
14355309,44946,CON30,4000,4,4000,0
14488399,44994,CON30,4000,3,3000,1000
14491021,44992,TC30,27000,,27000,0
14491021,44992,TC30,27000,25,25000,2000
14491177,44994,CON30,4000,4,4000,0
14516287,45006,CON30,4000,4,4000,0
14381721,44952,CON30,4000,4,4000,0
14331996,44929,CON30,4000,4,4000,0
14379374,44950,CON30,4000,4,4000,0
14344593,44937,CON30,4000,3,3000,1000
14408527,44964,CON30,4000,4,4000,0
14362089,44944,CON30,4000,4,4000,0
14386126,44953,CON30,4000,4,4000,0
14325087,44929,CON30,4000,4,4000,0
14435727,44974,CON30,4000,4,4000,0
14374620,44950,CON30,4000,4,4000,0
14420299,44965,CON30,4000,3,3000,1000
14331643,44931,CON30,4000,4,4000,0
14435436,44972,CON30,30750,31,31000,-250
14482304,44992,CON30,4000,4,4000,0
14346150,44944,CON30,4000,4,4000,0
14385857,44953,CON30,25000,26,26000,-1000
14332056,44936,CON30,30750,30,30000,750
14398977,44959,CON30,4000,,4000,0
14475132,44990,CON30,4000,4,4000,0
14392678,44956,CON30,4000,4,4000,0
14435738,44974,CON30,4000,4,4000,0
14434633,44977,CON30,4000,4,4000,0
14350295,44939,CON30,4000,5,5000,-1000
14414950,44966,CON30,4000,3,3000,1000
14414950,44966,CON30,4000,,4000,0
14396417,44959,CON30,4000,4,4000,0
14423533,44970,CON30,4000,4,4000,0
14362311,44942,CON30,31000,28,28000,3000
14434394,44978,CON30,4000,4,4000,0
14439207,44972,CON30,24000,28,28000,-4000
14398938,44959,CON30,4000,4,4000,0
14388863,44956,CON30,4000,4,4000,0
14383380,44952,CON30HC,30950,31,31000,-50
14512737,45000,TC30,30000,,30000,0
14512737,45000,TC30,30000,30,30000,0
14362653,44944,CON30,4000,4,4000,0
14474287,44992,CON30,29200,30,30000,-800
14385862,44952,CON30,4000,4,4000,0
14456974,44983,CON30,4000,4,4000,0
14516284,45006,CON30,4000,4,4000,0
14398976,44963,CON30,4000,3,3000,1000
14330430,44930,CON30,29280,30,30000,-720
14330430,44930,CON30,29280,,29280,0
14330430,44930,CON30,29280,,29280,0
14367147,44944,CON30,30640,29,29000,1640
14389483,44956,CON30,29280,29,29000,280
14327064,44929,CON30,4000,4,4000,0
14482303,44995,CON30,4000,4,4000,0
14490295,44994,CON30,4000,3,3000,1000
14355286,44943,CON30,4000,4,4000,0
14392837,44957,CON30,29280,29,29000,280
14443652,44978,CON30,29280,29,29000,280
14340759,44934,CON30,4000,4,4000,0
14462556,44986,CON30,29280,29,29000,280
14513139,45000,CON30,4000,4,4000,0
14387988,44956,CON30,4000,4,4000,0
14396396,44957,CON30,4000,4,4000,0
14327214,44928,CON30,29280,29,29000,280
14458493,44981,CON30,29280,30,30000,-720
14513969,45000,CON30,4000,4,4000,0
14328423,44941,CON30,4000,4,4000,0
14432547,44971,CON30,29280,30,30000,-720
14514040,45005,CON30,4000,4,4000,0
14501311,45001,CON30,29280,29,29000,280
14513741,45000,CON30,4000,4,4000,0
14381722,44952,CON30,4000,4,4000,0
14325974,44928,CON30,29280,30,30000,-720
14528794,45007,CON30,4000,4,4000,0
14396400,44957,CON30,4000,4,4000,0
14481490,44994,CON30,29280,30,30000,-720
14356835,44942,CON30,4000,5,5000,-1000
14364121,44945,CON30,4000,4,4000,0
14396720,44956,CON30,30800,27,27000,3800
14434417,44972,CON30,4000,4,4000,0
14477843,44992,CON30,4000,4,4000,0
14503440,45002,CON30,29280,30,30000,-720
14441825,44977,CON30,4000,4,4000,0
14422340,44970,CON30,4000,5,5000,-1000
14462135,44986,CON30,4000,4,4000,0
14362058,44944,CON30,29280,29,29000,280
14375784,44953,CON30,29280,30,30000,-720
14368215,44946,CON30,29280,29,29000,280
14521863,45009,CON30,29280,29,29000,280
14483953,44998,CON30,29280,29,29000,280
14454391,44980,CON30,29280,29,29000,280
14374642,44951,CON30,4000,4,4000,0
14462559,44986,CON30,29280,30,30000,-720
14401931,44963,CON30,4000,4,4000,0
14330395,44930,CON30,29280,,29280,0
14330395,44930,CON30,29280,29,29000,280
14475134,44988,CON30,4000,4,4000,0
14482305,44992,CON30,4000,4,4000,0
14443527,44973,CON30,4000,4,4000,0
14512154,45006,CON30,29280,30,30000,-720
14355289,44943,CON30,4000,4,4000,0
14362057,44944,CON30,29280,30,30000,-720
14463359,44987,CON30,29280,30,30000,-720
14326090,44929,CON30,4000,3,3000,1000
14382489,44950,CON30,30000,27,27000,3000
14325970,44928,CON30,29280,30,30000,-720
14402795,44960,CON30,29280,30,30000,-720
14443528,44974,CON30,4000,4,4000,0
14356756,44944,CON30,29280,29,29000,280
14509136,45005,CON30,29280,29,29000,280
14368216,44946,CON30,29280,30,30000,-720
14488392,44993,CON30,4000,4,4000,0
14479795,44991,CON30,4000,4,4000,0
14442642,44977,CON30,4000,5,5000,-1000
14364257,44949,CON30,4000,4,4000,0
14389481,44956,CON30,29280,29,29000,280
14509135,45005,CON30,29280,29,29000,280
14362056,44944,CON30,29280,29,29000,280
14398939,44959,CON30,4000,4,4000,0
14453701,44978,TC30,33000,27,27000,6000
14526029,45008,CON30,4000,4,4000,0
14454393,44980,CON30,29280,29,29000,280
14386064,44951,CON30,31000,28,28000,3000
14513970,45001,CON30,4000,4,4000,0
14339488,44931,TC30,34000,28,28000,6000
14327130,44928,CON30,29280,29,29000,280
14374736,44946,CON30,4000,4,4000,0
14444569,44978,CON30,4000,4,4000,0
14466302,44988,CON30,29280,30,30000,-720
14503442,45002,CON30,29280,30,30000,-720
14402797,44960,CON30,29280,29,29000,280
14398947,44963,CON30,4000,4,4000,0
14374619,44950,CON30,4000,3,3000,1000
14439854,44977,CON30,29280,29,29000,280
14352290,44938,CON30,4000,3,3000,1000
14495846,45000,CON30,26970,29,29000,-2030
14402798,44960,CON30,29280,29,29000,280
14439857,44977,CON30,29280,30,30000,-720
14468601,44984,CON30,26000,28,28000,-2000
14375786,44952,CON30,29280,30,30000,-720
14406018,44963,CON30,29280,29,29000,280
14326321,44930,CON30,29280,28,28000,1280
14479998,44995,CON30,4000,4,4000,0
14515724,45007,CON30,29280,30,30000,-720
14490280,44994,CON30,4000,4,4000,0
14528753,45006,CON30,4000,4,4000,0
14328426,44930,CON30,4000,4,4000,0
14389482,44956,CON30,29280,29,29000,280
14456973,44986,CON30,4000,4,4000,0
14433080,44972,CON30,4000,3,3000,1000
14330429,44931,CON30,29280,30,30000,-720
14422342,44970,CON30,4000,5,5000,-1000
14362053,44943,CON30,4000,3,3000,1000
14362061,44944,CON30,29280,30,30000,-720
14463362,44987,CON30,29280,29,29000,280
14530326,45009,CON30,4000,4,4000,0
14501310,45001,CON30,29280,29,29000,280
14348913,44939,CON30,29280,30,30000,-720
14346224,44938,CON30,4000,4,4000,0
14439856,44977,CON30,29280,30,30000,-720
14432549,44971,CON30,29280,30,30000,-720
14392840,44957,CON30,29280,29,29000,280
14344330,44936,CON30,29730,29,29000,730
14422677,44971,CON30,4000,4,4000,0
14462560,44986,CON30,29280,30,30000,-720
14375956,44952,CON30,29280,30,30000,-720
14344591,44937,CON30,4000,3,3000,1000
14406021,44963,CON30,29280,30,30000,-720
14387986,44956,CON30,4000,4,4000,0
14521865,45009,CON30,29280,29,29000,280
14488400,44993,CON30,4000,4,4000,0
14396605,44957,CON30,4000,4,4000,0
14396702,44957,CON30,29280,30,30000,-720
14422341,44970,CON30,4000,4,4000,0
14512153,45006,CON30,29280,30,30000,-720
14473014,44986,CON30,4000,4,4000,0
14435744,44978,CON30,4000,4,4000,0
14471408,44991,CON30,29280,29,29000,280
14375785,44952,CON30,29280,,29280,0
14426597,44971,CON30,32000,29,29000,3000
14446111,44980,CON30,4000,4,4000,0
14526024,45008,CON30,4000,4,4000,0
14450791,44979,CON30,29280,30,30000,-720
14439853,44977,CON30,29280,30,30000,-720
14391812,44953,CON30,29000,27,27000,2000
14461380,44984,CON30,29280,31,31000,-1720
14521864,45009,CON30,29280,30,30000,-720
14495845,45000,CON30,29280,29,29000,280
14368213,44950,CON30,29280,30,30000,-720
14419879,44966,CON30,4000,4,4000,0
14362062,44945,CON30,29280,30,30000,-720
14406017,44963,CON30,29280,29,29000,280
14399175,44959,CON30,29280,30,30000,-720
14451054,44979,CON30,29280,29,29000,280
14375952,44951,CON30,29280,29,29000,280
14364959,44950,CON30,29280,29,29000,280
14413807,44965,CON30,29280,29,29000,280
14330431,44931,CON30,29280,29,29000,280
14466300,44988,CON30,29280,30,30000,-720
14508437,45000,CON30,4000,4,4000,0
14495847,45000,CON30,29280,30,30000,-720
14375953,44951,CON30,29280,30,30000,-720
14423421,44970,CON30,29280,29,29000,280
14423428,44970,CON30,29280,30,30000,-720
14397156,44957,CON30,29280,30,30000,-720
14375129,44949,CON30,33000,28,28000,5000
14394512,44960,CON30,4000,4,4000,0
14462557,44986,CON30,29280,30,30000,-720
14461379,44984,CON30,29280,30,30000,-720
14362094,44946,CON30,29280,30,30000,-720
14451078,44979,CON30,29280,30,30000,-720
14443529,44973,CON30,4000,4,4000,0
14413785,44966,CON30,29280,29,29000,280
14381723,44952,CON30,4000,4,4000,0
14501312,45001,CON30,29280,30,30000,-720
14364311,44949,CON30,29280,29,29000,280
14439852,44977,CON30,29280,30,30000,-720
14423465,44970,CON30,29280,30,30000,-720
14520101,45008,CON30,4000,3,3000,1000
14502058,45005,CON30,4000,4,4000,0
14433082,44972,CON30,4000,4,4000,0
14514043,45005,CON30,4000,4,4000,0
14508438,45001,CON30,4000,4,4000,0
14376051,44951,CON30,4000,4,4000,0
14475772,44986,KTA,11000,7,7000,4000
14357781,44943,CON40,28000,25,25000,3000
14487988,44993,CON40,24000,24,24000,0
14487988,44993,CON40,24000,,24000,0
14345406,44935,SWAP20,15500,16,16000,-500
14361698,44942,SWAP20,16000,17,17000,-1000
14385052,44951,TC20,34000,32,32000,2000
14385115,44951,CON20,30000,30,30000,0
14385122,44951,CON20,29000,30,30000,-1000
14385129,44951,CON20,31000,30,30000,1000
14477611,44987,TC30,31000,30,30000,1000
14404530,44959,CON30,31900,28,28000,3900
14509605,44999,CON30,28000,29,29000,-1000
14496515,44995,TC30,30000,30,30000,0
14475037,44986,CON30,33000,30,30000,3000
14531418,45008,CON30,26000,28,28000,-2000
14331754,44931,CON30,32900,28,28000,4900
14330803,44928,CON30,32900,29,29000,3900
14331756,44931,CON30,34000,29,29000,5000
14330818,44930,CON30,35000,28,28000,7000
14527554,45006,CON30,30000,30,30000,0
14527554,45006,CON30,30000,,30000,0
14527554,45006,CON30,30000,,30000,0
14353337,44938,CON30,33000,28,28000,5000
14514127,45002,TC30,30000,29,29000,1000
14456514,44979,TC30,37000,28,28000,9000
14422464,44966,CON30,26000,30,30000,-4000
14422464,44966,CON30,26000,29,29000,-3000
14456955,44980,TC30,37000,29,29000,8000
14397603,44960,CON45,28356,30,30000,-1644
14330448,44929,CON45,14903,14,14000,903
14341536,44935,CON45,28356,28,28000,356
14460760,44981,CON45,11260,12,12000,-740
14493910,44994,CON45,30260,30,30000,260
14355284,44939,CON45,14903,14,14000,903
14352434,44949,CON45,28884,28,28000,884
14537790,45009,CON45,4500,4,4000,500
14528018,45007,CON45,27900,27,27000,900
14409111,44963,CON45,28886,30,30000,-1114
14528017,45007,CON45,27924,28,28000,-76
14516314,45002,CON45,4500,5,5000,-500
14414395,44964,CON45,28886,30,30000,-1114
14516316,45002,CON45,4500,4,4000,500
14537791,45009,CON45,4500,5,5000,-500
14446349,44977,CON45,14903,14,14000,903
14528016,45008,CON45,29860,30,30000,-140
14526267,45005,CON45,28260,28,28000,260
14362421,44945,CON45,30260,,30260,0
14526537,45006,CON45,28260,29,29000,-740
14336627,44930,CON45,28356,28,28000,356
14488082,44991,CON45,19985,20,20000,-15
14367934,44950,CON45,28356,29,29000,-644
14526539,45006,CON45,14903,15,15000,-97
14516315,45002,CON45,4500,6,6000,-1500
14490580,44993,CON45,4500,4,4000,500
14480369,44988,CON45,25337,26,26000,-663
14480369,44988,CON45,25337,,25337,0
14415043,44967,CON45,28476,29,29000,-524
14371669,44946,CON45,28476,29,29000,-524
14458226,44981,CON45,12380,13,13000,-620
14341533,44935,CON45,9292,10,10000,-708
14397604,44960,CON45,29004,30,30000,-996
14506849,44999,CON45,15130,15,15000,130
14397639,44958,CON45,28476,29,29000,-524
14491241,44993,CON45,4500,5,5000,-500
14352435,44944,CON45,28476,28,28000,476
14375733,44953,CON45,29004,29,29000,4
14375732,44953,CON45,28476,28,28000,476
14479812,44988,CON45,15130,16,16000,-870
14327415,44929,CON45,29004,29,29000,4
14452622,44978,CON45,30380,30,30000,380
14537817,45009,CON45,4500,,4500,0
14537817,45009,CON45,4500,,4500,0
14338123,44931,CON45,28690,29,29000,-310
14426752,44970,CON45,28476,30,30000,-1524
14349279,44939,CON45,29004,29,29000,4
14367948,44956,CON45,29004,29,29000,4
14458224,44979,CON45,4500,4,4000,500
14496902,44999,CON30,4000,3,3000,1000
14396222,44956,CON30,4000,4,4000,0
14333308,44935,CON30,4000,4,4000,0
14392289,44957,CON30,4000,4,4000,0
14401930,44963,CON30,4000,4,4000,0
14508439,45002,CON30,4000,3,3000,1000
14451576,44979,CON30,4000,4,4000,0
14336530,44930,CON30,34000,30,30000,4000
14443525,44978,CON30,4000,4,4000,0
14348290,44936,CON30,28000,31,31000,-3000
14346226,44942,CON30,4000,3,3000,1000
14444586,44978,CON30,4000,4,4000,0
14496868,44994,CON30,31000,30,30000,1000
14446949,44978,CON30,4000,4,4000,0
14364265,44949,CON30,31050,32,32000,-950
14496328,44998,CON30,4000,4,4000,0
14339342,44931,CON30,34000,28,28000,6000
14408003,44965,CON30,4000,4,4000,0
14358121,44943,CON45,4500,4,4000,500
14478067,44991,CON40,20350,20,20000,350
14478068,44991,CON40,20500,20,20000,500
14453882,44998,TC20,5000,5,5000,0
14350351,44959,TC20,5000,5,5000,0
14350430,44978,TC20,5000,4,4000,1000
14350463,44985,TC20,5000,4,4000,1000
14288232,44944,TC20,5000,5,5000,0
14288204,44930,TC20,5000,5,5000,0
14391598,44960,CON40,30000,30,30000,0
14288215,44937,TC20,5000,5,5000,0
14350465,44987,TC20,5000,5,5000,0
14350428,44972,TC20,5000,5,5000,0
14350354,44960,TC20,5000,3,3000,2000
14349005,44950,TC20,5000,4,4000,1000
14453916,45007,TC20,5000,3,3000,2000
14453905,45007,TC20,5000,4,4000,1000
14453881,45000,TC20,5000,5,5000,0
14350417,44971,TC20,5000,5,5000,0
14350346,44959,TC20,5000,4,4000,1000
14350443,44986,TC20,5000,5,5000,0
14288212,44935,TC20,5000,5,5000,0
14288238,44945,TC20,5000,5,5000,0
14288227,44939,TC20,5000,5,5000,0
14350517,44993,TC20,5000,4,4000,1000
14350427,44979,TC20,5000,5,5000,0
14350357,44960,TC20,5000,5,5000,0
14349004,44950,TC20,5000,4,4000,1000
14453908,45008,TC20,5000,5,5000,0
14453877,44998,TC20,5000,3,3000,2000
14350409,44970,TC20,5000,5,5000,0
14350342,44957,TC20,5000,5,5000,0
14350441,44981,TC20,5000,5,5000,0
14350467,44988,TC20,5000,5,5000,0
14350423,44974,TC20,5000,4,4000,1000
14349011,44964,TC20,5000,5,5000,0
14350369,44967,TC20,5000,5,5000,0
14350341,44956,TC20,5000,5,5000,0
14350341,44956,TC20,5000,,5000,0
14350442,44980,TC20,5000,5,5000,0
14350523,44995,TC20,5000,5,5000,0
14288236,44942,TC20,5000,5,5000,0
14453914,45008,TC20,5000,5,5000,0
14453902,45005,TC20,5000,4,4000,1000
14288202,44930,TC20,5000,5,5000,0
14288235,44944,TC20,5000,5,5000,0
14350471,44991,TC20,5000,5,5000,0
14350347,44967,TC20,5000,5,5000,0
14350434,44978,TC20,5000,,5000,0
14350434,44978,TC20,5000,5,5000,0
14350433,44974,TC20,5000,5,5000,0
14350360,44964,TC20,5000,4,4000,1000
14350360,44964,TC20,5000,,5000,0
14350470,44987,TC20,5000,5,5000,0
14349009,44952,TC20,5000,5,5000,0
14349009,44952,TC20,5000,,5000,0
14288229,44942,TC20,5000,5,5000,0
14288190,44928,TC20,5000,5,5000,0
14453901,45005,TC20,5000,4,4000,1000
14453906,45006,TC20,5000,4,4000,1000
14288216,44938,TC20,5000,5,5000,0
14349021,44953,TC20,5000,5,5000,0
14350512,44992,TC20,5000,5,5000,0
14350368,44965,TC20,5000,5,5000,0
14350437,44978,TC20,5000,4,4000,1000
14350425,44974,TC20,5000,5,5000,0
14350340,44957,TC20,5000,5,5000,0
14350455,44986,TC20,5000,5,5000,0
14288196,44929,TC20,5000,5,5000,0
14288196,44929,TC20,5000,,5000,0
14288230,44943,TC20,5000,5,5000,0
14453892,45001,TC20,5000,5,5000,0
14350519,44994,TC20,5000,5,5000,0
14350445,44980,TC20,5000,5,5000,0
14350373,44967,TC20,5000,5,5000,0
14349015,44957,TC20,5000,5,5000,0
14350376,44967,TC20,5000,5,5000,0
14350336,44956,TC20,5000,5,5000,0
14350439,44981,TC20,5000,5,5000,0
14350527,44995,TC20,5000,5,5000,0
14288233,44943,TC20,5000,5,5000,0
14288201,44931,TC20,5000,5,5000,0
14288205,44931,TC20,5000,5,5000,0
14288237,44944,TC20,5000,5,5000,0
14350449,44984,TC20,5000,3,3000,2000
14350343,44958,TC20,5000,4,4000,1000
14350416,44970,TC20,5000,5,5000,0
14453907,45006,TC20,5000,5,5000,0
14453878,44999,TC20,5000,5,5000,0
14350414,44971,TC20,5000,3,3000,2000
14350345,44958,TC20,5000,4,4000,1000
14350448,44985,TC20,5000,5,5000,0
14288225,44946,TC20,5000,5,5000,0
14350440,44988,TC20,5000,5,5000,0
14350358,44964,TC20,5000,5,5000,0
14349012,44952,TC20,5000,5,5000,0
14453890,45002,TC20,5000,3,3000,2000
14453909,45006,TC20,5000,4,4000,1000
14349019,44952,TC20,5000,5,5000,0
14350367,44965,TC20,5000,5,5000,0
14350436,44978,TC20,5000,5,5000,0
14350510,44992,TC20,5000,5,5000,0
14350454,44987,TC20,5000,4,4000,1000
14350420,44972,TC20,5000,4,4000,1000
14288241,44946,TC20,5000,,5000,0
14288241,44946,TC20,5000,5,5000,0
14288218,44936,TC20,5000,5,5000,0
14396032,44959,TC20,5000,4,4000,1000
14453886,45001,TC20,5000,4,4000,1000
14453879,44998,TC20,5000,5,5000,0
14288221,44936,TC20,5000,5,5000,0
14350431,44973,TC20,5000,5,5000,0
14350355,44963,TC20,5000,5,5000,0
14349007,44950,TC20,5000,5,5000,0
14350447,44980,TC20,5000,5,5000,0
14288194,44930,TC20,5000,5,5000,0
14288213,44935,TC20,5000,5,5000,0
14288240,44946,TC20,5000,5,5000,0
14288240,44946,TC20,5000,,5000,0
14350468,44987,TC20,5000,5,5000,0
14350356,44960,TC20,5000,3,3000,2000
14350424,44972,TC20,5000,4,4000,1000
14453894,45002,TC20,5000,5,5000,0
14453888,45000,TC20,5000,5,5000,0
14350352,44960,TC20,5000,3,3000,2000
14349003,44949,TC20,5000,5,5000,0
14349003,44949,TC20,5000,,5000,0
14288222,44936,TC20,5000,5,5000,0
14349018,44953,TC20,5000,5,5000,0
14350370,44966,TC20,5000,5,5000,0
14350446,44981,TC20,5000,5,5000,0
14350526,44995,TC20,5000,5,5000,0
14453910,45008,TC20,5000,4,4000,1000
14350528,44995,TC20,5000,5,5000,0
14350444,44981,TC20,5000,5,5000,0
14350375,44966,TC20,5000,5,5000,0
14383611,44953,TC20,5000,5,5000,0
14350366,44965,TC20,5000,4,4000,1000
14350438,44979,TC20,5000,5,5000,0
14349020,44953,TC20,5000,5,5000,0
14288220,44938,TC20,5000,5,5000,0
14453870,44999,TC20,5000,5,5000,0
14453919,45009,TC20,5000,5,5000,0
14453891,45001,TC20,5000,4,4000,1000
14288223,44937,TC20,5000,2,2000,3000
14349010,44951,TC20,5000,,5000,0
14349010,44951,TC20,5000,,5000,0
14349010,44951,TC20,5000,5,5000,0
14350359,44964,TC20,5000,5,5000,0
14460537,44981,CON30,4000,4,4000,0
14461012,44987,TC20,26050,28,28000,-1950
14434849,44980,CON30,4000,4,4000,0
14348903,44945,CON30,4000,4,4000,0
14525132,45008,CON30,4000,4,4000,0
14417028,44974,CON30,4000,4,4000,0
14417082,44978,CON30,4000,4,4000,0
14380072,44959,CON30,4000,4,4000,0
14332012,44938,CON30,4000,3,3000,1000
14511523,45006,CON30,4000,,4000,0
14511523,45006,CON30,4000,4,4000,0
14429122,45007,CON30,3000,3,3000,0
14317991,44963,CON30,3000,3,3000,0
14334632,44984,CON30,3000,3,3000,0
14408372,44963,CON30,1900,2,2000,-100
14318486,44967,CON30,1900,2,2000,-100
14243615,44931,CON30,1900,4,4000,-2100
14428853,45005,CON30,1900,2,2000,-100
14317995,44963,CON30,1900,4,4000,-2100
14335343,44991,CON30,1900,1,1000,900
14335816,44995,CON30,1900,2,2000,-100
14317198,44953,CON30,1900,5,5000,-3100
14243355,44928,CON30,1900,2,2000,-100
14243509,44929,CON30,1900,2,2000,-100
14318484,44967,CON30,1900,5,5000,-3100
14429127,45007,CON30,1900,4,4000,-2100
14317455,44957,CON30,3000,3,3000,0
14243999,44936,CON30,3000,4,4000,-1000
14334441,44981,CON30,3000,3,3000,0
14334053,44974,CON30,3000,3,3000,0
14251349,44946,CON30,3000,4,4000,-1000
14428960,45006,CON30,3000,4,4000,-1000
14244395,44939,CON30,1900,2,2000,-100
14333750,44980,CON30,1900,2,2000,-100
14526038,45005,TC40,27000,,27000,0
14516535,45007,TC40,39000,30,30000,9000
14526041,45008,TC40,7000,,7000,0
14346074,44936,CON40,4000,3,3000,1000
14421510,44973,CON40,4000,4,4000,0
14332881,44935,CON40,31000,31,31000,0
14496625,44995,CON40,4000,4,4000,0
14433454,44970,TC40,7000,7,7000,0
14460552,44981,TC40,7000,5,5000,2000
14507798,44999,TC40,37000,32,32000,5000
14507798,44999,TC40,37000,,37000,0
14502511,44999,TC40,39000,36,36000,3000
14502511,44999,TC40,39000,,39000,0
14347258,44944,CON40,30000,30,30000,0
14516532,45007,TC40,39000,35,35000,4000
14520857,45002,CON40,4000,4,4000,0
14481945,44994,CON40,4000,4,4000,0
14427689,44971,CON40,4000,4,4000,0
14453822,44980,CON40,4000,4,4000,0
14345527,44939,CON40,4000,4,4000,0
14396661,44956,CON40,4000,4,4000,0
14354785,44945,TC40,29600,29,29000,600
14409687,44960,CON40HC,4000,4,4000,0
14436963,44977,CON40,4000,4,4000,0
14452641,44980,CON40,4000,4,4000,0
14472257,44994,CON40,4000,4,4000,0
14399149,44958,CON40,4000,4,4000,0
14361489,44945,CON40,4000,4,4000,0
14332209,44935,TC40,32000,27,27000,5000
14402286,44960,TC40,30100,30,30000,100
14460177,44984,TC40,31100,30,30000,1100
14526315,45006,CON40,4000,4,4000,0
14361401,44946,CON40,4000,4,4000,0
14361401,44946,CON40,4000,,4000,0
14371678,44953,CON40,4000,4,4000,0
14351743,44942,CON40,30000,30,30000,0
14350374,44945,CON40,29000,29,29000,0
14417002,44965,CON40,4000,5,5000,-1000
14439724,44980,CON40,30000,30,30000,0
14525754,45008,TC40,37000,,37000,0
14361403,44949,CON40,4000,4,4000,0
14529169,45008,CON40,4000,4,4000,0
14326564,44935,CON40,4000,4,4000,0
14361400,44943,CON40,4000,4,4000,0
14362139,44946,CON40,4000,,4000,0
14362139,44946,CON40,4000,4,4000,0
14408845,44964,CON40,4000,4,4000,0
14350493,44946,TC40,31100,31,31000,100
14357971,44942,CON40,4000,4,4000,0
14419482,44966,CON40HC,4000,5,5000,-1000
14506947,44998,TC40,38000,,38000,0
14506947,44998,TC40,38000,34,34000,4000
14515199,45007,TC40,7000,4,4000,3000
14446997,44980,CON40,30000,30,30000,0
14515200,45007,TC40,7000,4,4000,3000
14379095,44951,TC20,25330,24,24000,1330
14414775,44964,TC20,20350,24,24000,-3650
14368366,44946,TC20,29000,29,29000,0
14447068,44978,TC23,32000,32,32000,0
14493930,45008,TC23,32000,30,30000,2000
14502014,44995,TC20,30000,29,29000,1000
14502014,44995,TC20,30000,,30000,0
14433523,44978,TC20,26500,25,25000,1500
14411966,44963,TC20,28550,29,29000,-450
14387509,44956,TC26,27080,27,27000,80
14413734,44966,TC26,27000,27,27000,0
14531333,45007,TC26,31000,28,28000,3000
14531333,45007,TC26,31000,,31000,0
14490276,44995,TC26,29140,29,29000,140
14506435,44999,TC23,31840,31,31000,840
14464880,44981,TRA,32000,18,18000,14000
14418897,44965,TRA,32000,32,32000,0
14372711,44945,TRA,32000,25,25000,7000
14515756,45007,TC26,30980,31,31000,-20
14468538,44984,TC20,5000,5,5000,0
14397592,44959,TC20,26980,26,26000,980
14516300,45006,TC20,26980,26,26000,980
14507297,44998,TC20,6000,,6000,0
14507297,44998,TC20,6000,2,2000,4000
14507297,44998,TC20,6000,4,4000,2000
14507297,44998,TC20,6000,2,2000,4000
14439720,44973,TC20,26980,26,26000,980
14392941,44956,TC20,6980,5,5000,1980
14392941,44956,TC20,6980,2,2000,4980
14373291,44946,TC20,6980,5,5000,1980
14383134,44952,TC20,26980,30,30000,-3020
14413977,44963,TC20,5000,3,3000,2000
14330728,44935,TC20,26980,28,28000,-1020
14348059,44943,TC20,26980,288,28800,-1820
14407489,44960,TC20,6980,2,2000,4980
14480021,44991,TC20,26980,28,28000,-1020
14487372,44992,TC20,26980,26,26000,980
14523494,45005,TC20,5000,2,2000,3000
14498368,44998,TC20,26980,27,27000,-20
14373293,44946,TC20,6980,3,3000,3980
14390567,44956,TC20,26980,27,27000,-20
14357527,44939,TC20,6980,2,2000,4980
14432605,44970,TC20,5000,3,3000,2000
14514911,45000,TC20,5000,2,2000,3000
14373298,44948,TC20,6980,2,2000,4980
14373298,44948,TC20,6980,2,2000,4980
14531065,45008,TC20,26980,30,30000,-3020
14384520,44951,TC20,6980,2,2000,4980
14397582,44958,TC20,26980,26,26000,980
14480022,44991,TC20,26980,26,26000,980
14425696,44967,TC20,5000,2,2000,3000
14479729,44987,TC20,5000,5,5000,0
14420413,44970,TC20,26980,27,27000,-20
14532593,45007,TC20,5000,3,3000,2000
14341083,44935,TC20,5000,2,2000,3000
14457690,44979,TC20,5000,2,2000,3000
14457628,44981,TC20,26980,30,30000,-3020
14517226,45001,TC20,5000,2,2000,3000
14328720,44928,TC20,7000,5,5000,2000
14349036,44938,TC20,26980,26,26000,980
14407493,44962,TC20,6980,2,2000,4980
14531066,45008,TC20,26980,27,27000,-20
14341107,44936,TC20,6970,3,3000,3970
14523495,45005,TC20,5000,2,2000,3000
14469469,44987,TC20,26980,26,26000,980
14453014,44978,TC20,6980,2,2000,4980
14405455,44963,TC20,26980,26,26000,980
14398398,44957,TC20,8980,4,4000,4980
14328569,44929,TC20,26980,26,26000,980
14492374,44994,TC20,5000,5,5000,0
14507299,44998,TC20,6000,4,4000,2000
14507299,44998,TC20,6000,,6000,0
14454357,44984,TC20,26980,27,27000,-20
14341108,44936,TC20,6980,2,2000,4980
14521080,45006,TC20,26980,26,26000,980
14467280,44983,TC20,5000,5,5000,0
14439605,44974,TC20,26980,26,26000,980
14479053,44987,TC20,5000,5,5000,0
14345585,44937,TC20,26980,28,28000,-1020
14407496,44962,TC20,6980,2,2000,4980
14405172,44963,TC20,26980,28,28000,-1020
14328570,44929,TC20,26980,27,27000,-20
14363229,44943,TC20,6980,2,2000,4980
14445498,44974,TC20,5000,5,5000,0
14439849,44972,TC20,5000,2,2000,3000
14487367,44993,TC20,26980,30,30000,-3020
14330735,44937,TC20,26980,27,27000,-20
14413981,44963,TC20,5000,3,3000,2000
14489991,44992,TC20,5000,2,2000,3000
14446943,44979,TC20,26980,25,25000,1980
14462197,44980,TC20,5000,5,5000,0
14498369,44999,TC20,26980,26,26000,980
14418151,44967,TC20,26980,26,26000,980
14393227,44956,TC20,6980,5,5000,1980
14393227,44956,TC20,6980,2,2000,4980
14536891,45009,TC20,5000,,5000,0
14536891,45009,TC20,5000,2,2000,3000
14378396,44949,TC20,6980,3,3000,3980
14326319,44928,TC20,26980,26,26000,980
14498370,45000,TC20,26980,27,27000,-20
14328648,44929,TC20,26980,26,26000,980
14393229,44956,TC20,6980,3,3000,3980
14378399,44950,TC20,6980,2,2000,4980
14416705,44965,TC20,26980,26,26000,980
14330734,44937,TC20,26980,27,27000,-20
14453020,44978,TC20,6980,2,2000,4980
14361417,44942,TC20,6980,2,2000,4980
14338900,44931,TC20,6980,2,2000,4980
14454910,44978,TC20,6980,2,2000,4980
14495984,44994,TC20,6980,5,5000,1980
14520340,45007,TC20,26980,27,27000,-20
14341111,44936,TC20,6980,3,3000,3980
14357309,44943,TC20,26980,27,27000,-20
14413982,44963,TC20,5000,3,3000,2000
14507337,44998,TRA,29000,34,34000,-5000
14434378,44970,TRA,28000,14,14000,14000
14529749,45006,TRA,32000,16,16000,16000
14531795,45007,TRA,25000,22,22000,3000
14478523,44987,TRA,32000,12,12000,20000
14507827,44998,TRA,32000,32,32000,0
14510752,44999,TRA,35000,36,36000,-1000
14533037,45007,TRA,35000,29,29000,6000
14514801,45000,TRA,12000,,12000,0
14514801,45000,TRA,12000,12,12000,0
14478993,44987,TRA,32000,,32000,0
14478993,44987,TRA,32000,25,25000,7000
14517589,45001,TRA,32000,12,12000,20000
14357545,44939,TRA,39000,23,23000,16000
14351105,44938,TRA,35000,18,18000,17000
14376257,44946,TRA,35000,21,21000,14000
14520771,45002,TRA,32000,29,29000,3000
14520771,45002,TRA,32000,,32000,0
14346131,44935,TRA,43000,35,35000,8000
14536052,45008,TRA,28000,28,28000,0
14497365,44994,TRA,32000,25,25000,7000
14465223,44981,TRA,30000,34,34000,-4000
14452496,44977,TRA,28000,27,27000,1000
14491819,44992,TRA,25000,24,24000,1000
14483143,44988,TRA,25000,20,20000,5000
14440337,44972,TRA,32000,10,10000,22000
14382997,44950,TRA,32000,14,14000,18000
14423195,44966,TRA,25000,14,14000,11000
14402948,44958,TRA,39000,34,34000,5000
14355964,44938,TRA,32000,17,17000,15000
14361524,44942,TRA,32000,18,18000,14000
14376250,44946,TRA,32000,21,21000,11000
14510465,44999,TRA,29000,29,29000,0
14405915,44959,TRA,21000,15,15000,6000
14407578,44960,TRA,25000,,25000,0
14407578,44960,TRA,25000,15,15000,10000
14349906,44937,TRA,32000,27,27000,5000
14470770,44984,TRA,32000,14,14000,18000
14508669,44998,TRA,25000,14,14000,11000
14476997,44986,TRA,36000,28,28000,8000
14446856,44974,TRA,28000,15,15000,13000
14498822,44994,TRA,32000,29,29000,3000
14520860,45002,TRA,32000,,32000,0
14520860,45002,TRA,32000,,32000,0
14520860,45002,TRA,32000,20,20000,12000
14533414,45008,TRA,36000,,36000,0
14533414,45008,TRA,36000,,36000,0
14533581,45008,TRA,37000,37,37000,0
14530981,45007,TRA,36000,37,37000,-1000
14530981,45007,TRA,36000,,36000,0
14330751,44928,TRA,32000,30,30000,2000
14332399,44929,TRA,32000,20,20000,12000
14353760,44938,TRA,32000,14,14000,18000
14517626,45001,TRA,28000,25,25000,3000
14469726,44984,TRA,25000,14,14000,11000
14340727,44934,TRA,32000,10,10000,22000
14463993,44981,TRA,28000,14,14000,14000
14502552,44995,TRA,28000,,28000,0
14380345,44949,TRA,32000,17,17000,15000
14502555,44995,TRA,32000,20,20000,12000
14502555,44995,TRA,32000,,32000,0
14502555,44995,TRA,32000,19,19000,13000
14404528,44959,TRA,41000,25,25000,16000
14404528,44959,TRA,41000,,41000,0
14404528,44959,TRA,41000,25,25000,16000
14337564,44930,TRA,32000,22,22000,10000
14369883,44944,TRA,35000,27,27000,8000
14495121,44993,TRA,24000,25,25000,-1000
14495051,44993,TRA,36000,34,34000,2000
14520975,45002,TRA,32000,,32000,0
14520975,45002,TRA,32000,34,34000,-2000
14471275,44985,TRA,34000,15,15000,19000
14503322,44997,TRA,32000,28,28000,4000
14469866,44984,TRA,32000,28,28000,4000
14477066,44986,TRA,32000,27,27000,5000
14521169,45002,TRA,28000,,28000,0
14521169,45002,TRA,28000,28,28000,0
14535501,45008,TRA,32000,,32000,0
14535501,45008,TRA,32000,22,22000,10000
14535501,45008,TRA,32000,,32000,0
14535501,45008,TRA,32000,22,22000,10000
14535501,45008,TRA,32000,,32000,0
14535501,45008,TRA,32000,22,22000,10000
14413162,44963,TRA,25000,19,19000,6000
14524658,45005,TRA,25000,19,19000,6000
14409610,44960,TRA,32000,12,12000,20000
14372712,44945,TRA,39000,15,15000,24000
14390609,44952,TRA,25000,15,15000,10000
14352392,44937,TRA,32000,15,15000,17000
14437660,44971,TRA,28000,16,16000,12000
14440339,44972,TRA,28000,19,19000,9000
14531798,45007,TRA,25000,20,20000,5000
14387508,44951,TRA,39000,31,31000,8000
14423071,44967,TRA,41000,33,33000,8000
14402949,44958,TRA,39000,13,13000,26000
14426782,44967,TRA,28000,35,35000,-7000
14517236,45001,FLA20,0,0,0,0
14517235,45001,FLA20,0,0,0,0
14517234,45001,FLA20,0,0,0,0
14517237,45001,FLA20,0,0,0,0
14517238,45001,FLA20,0,0,0,0
14397857,44958,CON30,3000,4,4000,-1000
14461994,44981,CON30,4000,4,4000,0
14447174,44977,CON30,4000,4,4000,0
14535599,45008,CON30,3000,,3000,0
14387212,44952,CON30,30000,30,30000,0
14384282,44951,CON30,3000,3,3000,0
14462198,44986,CON30,30000,30,30000,0
14396570,44956,CON30,3000,3,3000,0
14452179,44981,CON30,30000,30,30000,0
14384283,44951,CON30,3000,3,3000,0
14309858,44931,CON30,30340,30,30000,340
14443296,44974,CON30,4000,4,4000,0
14436344,44972,CON30,4000,4,4000,0
14421544,44966,CON30,3000,3,3000,0
14488024,44992,CON30,4000,4,4000,0
14389526,44956,CON30,27060,27,27000,60
14502591,45000,CON30,3000,3,3000,0
14387282,44958,CON30,30000,30,30000,0
14483313,44993,CON30,29555,30,30000,-445
14327449,44928,CON30,26820,27,27000,-180
14526554,45006,CON30,3000,3,3000,0
14436372,44973,CON30,4000,4,4000,0
14381030,44951,CON30,3000,3,3000,0
14516429,45002,CON30,3000,3,3000,0
14332507,44938,CON30,26040,26,26000,40
14309857,44931,CON30,30000,30,30000,0
14454019,44978,CON30,4000,4,4000,0
14358041,44943,CON30,4000,4,4000,0
14387281,44958,CON30,30340,30,30000,340
14387281,44958,CON30,30340,,30340,0
14333180,44943,CON30,29180,30,30000,-820
14454022,44978,CON30,4000,5,5000,-1000
14470650,44985,CON30,4000,4,4000,0
14455579,44985,CON30,25520,25,25000,520
14387215,44952,CON30,3000,3,3000,0
14447186,44977,CON30,4000,4,4000,0
14497300,44995,CON30,27705,28,28000,-295
14433452,44971,CON30,4000,,4000,0
14461995,44981,CON30,4000,4,4000,0
14465479,44984,CON30,4000,4,4000,0
14498950,44998,CON30,4000,4,4000,0
14384279,44951,CON30,3000,,3000,0
14470648,44985,CON30,4000,4,4000,0
14372866,44946,CON30,4000,3,3000,1000
14426564,44971,CON30,29240,30,30000,-760
14362050,44944,CON30,4000,4,4000,0
14420202,44966,CON30,27880,28,28000,-120
14389527,44957,CON30,28140,28,28000,140
14529395,45008,CON30,3000,3,3000,0
14309852,44930,CON30,30380,30,30000,380
14347608,44937,CON30,4000,4,4000,0
14457605,44980,CON30,4000,3,3000,1000
14454023,44978,CON30,4000,4,4000,0
14353765,44939,CON30,4000,4,4000,0
14462204,44987,CON30,30000,31,31000,-1000
14389533,44957,CON30,30000,30,30000,0
14363140,44945,CON30,30660,30,30000,660
14508550,44999,CON30,3000,3,3000,0
14511685,45006,CON30,30000,30,30000,0
14498949,44995,CON30,4000,4,4000,0
14376823,44949,CON30,3000,4,4000,-1000
14381031,44950,CON30,3000,4,4000,-1000
14396566,44957,CON30,3000,3,3000,0
14437663,44973,CON30,4000,4,4000,0
14409362,44963,CON30,29340,30,30000,-660
14436373,44972,CON30,4000,4,4000,0
14387279,44956,CON30,25800,25,25000,800
14502479,44998,CON30,3000,3,3000,0
14437661,44973,CON30,4000,4,4000,0
14443258,44974,CON30,4000,4,4000,0
14513711,45001,CON30,3000,3,3000,0
14332509,44937,CON30,30340,30,30000,340
14403357,44963,CON30,30000,30,30000,0
14479069,44994,CON30,30500,30,30000,500
14436345,44972,CON30,4000,4,4000,0
14389565,44959,CON30,26360,27,27000,-640
14350674,44938,CON30,4000,4,4000,0
14381027,44950,CON30,3000,4,4000,-1000
14516428,45002,CON30,3000,3,3000,0
14516428,45002,CON30,3000,,3000,0
14502488,44999,CON30,3000,3,3000,0
14387213,44953,CON30,30000,30,30000,0
14387280,44956,CON30,30360,31,31000,-640
14473070,44991,CON30,30280,30,30000,280
14389529,44957,CON30,30000,30,30000,0
14521009,45005,CON30,3000,3,3000,0
14358291,44943,CON30,4000,4,4000,0
14457608,44979,CON30,4000,4,4000,0
14511852,45009,CON30,30000,30,30000,0
14498483,44999,CON30,26920,26,26000,920
14444356,44978,CON30,30000,30,30000,0
14534056,45008,CON30,3000,,3000,0
14470649,44985,CON30,4000,5,5000,-1000
14452180,44981,CON30,30000,30,30000,0
14361402,44943,TC20,25100,25,25000,100
14345468,44936,TC20,25140,25,25000,140
14494136,44994,TC20,5000,5,5000,0
14515717,45005,TC20,23730,23,23000,730
14339520,44935,TC20,25000,25,25000,0
14381409,44952,TC20,32000,32,32000,0
14345452,44937,TC20,25120,26,26000,-880
14362184,44944,TC20,5000,5,5000,0
14413214,44964,TC20,5000,5,5000,0
14327876,44929,TC20,5000,5,5000,0
14515556,45002,TC20,5000,,5000,0
14515556,45002,TC20,5000,4,4000,1000
14515556,45002,TC20,5000,,5000,0
14507894,45000,TC20,26640,26,26000,640
14482451,44988,TC20,5000,3,3000,2000
14481954,45001,TC20,23735,24,24000,-265
14454049,44980,TC20,29000,29,29000,0
14380488,44950,TC20,28680,30,30000,-1320
14521050,45006,TC20,29000,29,29000,0
14512706,45005,TC20,19000,19,19000,0
14351394,44939,TC20,24840,25,25000,-160
14487590,44993,TC20,27690,28,28000,-310
14508293,45001,TC20,32000,32,32000,0
14496917,44995,TC20,5000,5,5000,0
14401986,44960,TC20,29690,30,30000,-310
14439773,44973,TC20,29000,23,23000,6000
14464545,44984,TC20,23880,23,23000,880
14502822,45005,TC20,25100,25,25000,100
14444593,44974,TC20,23730,23,23000,730
14444593,44974,TC20,23730,,23730,0
14444593,44974,TC20,23730,,23730,0
14444593,44974,TC20,23730,,23730,0
14537018,45009,TC20,25000,,25000,0
14488683,44993,TC20,26690,30,30000,-3310
14331116,44928,CON20,32000,28,28000,4000
14452785,44979,TC20,32000,32,32000,0
14444185,44978,TC20,27620,27,27000,620
14352655,44942,TC20,26510,26,26000,510
14508284,44999,TC20,25000,25,25000,0
14406040,44959,TC20,27640,28,28000,-360
14409137,44963,TC20,26000,4,4000,22000
14346448,44935,TC20,34000,32,32000,2000
14346448,44935,TC20,34000,,34000,0
14525864,45006,TC20,33000,33,33000,0
14400152,44958,TC20,31560,26,26000,5560
14417058,44965,TC20,25850,25,25000,850
14367964,44945,TC20,25000,24,24000,1000
14508581,44998,TC20,5000,,5000,0
14508581,44998,TC20,5000,4,4000,1000
14347448,44937,TC26,32000,30,30000,2000
14476698,44988,TC20,17000,17,17000,0
14532528,45009,TC20,15000,15,15000,0
14388862,44956,TC20,24050,24,24000,50
14507904,45000,TC20,27740,27,27000,740
14513705,45002,TC23,35580,32,32000,3580
14470465,44987,TC23,32000,32,32000,0
14326341,44928,TC23,32000,32,32000,0
14459936,44981,TC20,5000,,5000,0
14459936,44981,TC20,5000,5,5000,0
14459936,44981,TC20,5000,,5000,0
14406045,44963,TC23,5000,4,4000,1000
14357486,44942,TC20,5000,5,5000,0
14391792,44953,TC20,10000,5,5000,5000
14375119,44949,TC20,10000,6,6000,4000
14326432,44929,TC20,28060,28,28000,60
14446525,44979,TC20,28040,28,28000,40
14498032,44998,TC20,5000,5,5000,0
14498032,44998,TC20,5000,,5000,0
14532526,45008,TC23,5000,6,6000,-1000
14532526,45008,TC23,5000,,5000,0
14483242,44991,TC20,32000,32,32000,0
14444116,44977,TC20,5000,,5000,0
14444116,44977,TC20,5000,5,5000,0
14469802,44988,TC20,27960,30,30000,-2040
14510336,44999,TC20,31000,31,31000,0
14510336,44999,TC20,31000,,31000,0
14370673,44945,TC20,5000,,5000,0
14370673,44945,TC20,5000,4,4000,1000
14417339,44964,TC20,9000,4,4000,5000
14338015,44931,TC20,30120,30,30000,120
14488783,44991,TC20,27100,27,27000,100
14488783,44991,TC20,27100,,27100,0
14521093,45005,TC23,31000,30,30000,1000
14461485,44985,TC20,5000,4,4000,1000
14397274,44957,TC23,33000,33,33000,0
14326653,44931,TC20,30920,31,31000,-80
14331720,44931,TC23,32000,32,32000,0
14354446,44939,TC23,31000,31,31000,0
14433495,44972,TC23,32980,33,33000,-20
14515731,45002,TC20,27220,28,28000,-780
14352609,44939,TC20,30640,26,26000,4640
14352609,44939,TC20,30640,26,26000,4640
14524060,45005,TC23,25000,25,25000,0
14443646,44974,TC20,5000,5,5000,0
14433088,44970,TC20,27420,28,28000,-580
14481537,44991,TC20,31920,30,30000,1920
14382860,44951,TC23,25000,25,25000,0
14490007,44993,TC20,27940,28,28000,-60
14339447,44942,TC23,33000,31,31000,2000
14413211,44967,TC23,26000,26,26000,0
14444186,44977,TC20,30940,32,32000,-1060
14433720,44971,TC20,30260,31,31000,-740
14339510,44931,TC23,32000,27,27000,5000
14460649,44981,TC20,30180,31,31000,-820
14367146,44944,TC23,31960,27,27000,4960
14478973,44988,TC20,31940,31,31000,940
14375677,44950,TC23,30000,30,30000,0
14473449,44986,TC23,30000,30,30000,0
14452624,44978,TC20,26420,27,27000,-580
14482690,44988,TC20,5000,,5000,0
14482690,44988,TC20,5000,,5000,0
14517255,45001,TC23,5000,,5000,0
14517255,45001,TC23,5000,4,4000,1000
14482306,44991,TC20,31920,31,31000,920
14373382,44949,TC23,30000,30,30000,0
14436028,44971,TC20,5000,4,4000,1000
14478775,44991,TC20,5000,5,5000,0
14330164,44930,TC20,5000,4,4000,1000
14442708,44974,TC20,5000,5,5000,0
14446848,44974,TC26,5000,4,4000,1000
14373178,44946,TC20,32780,27,27000,5780
14421556,44970,TC26,28000,28,28000,0
14339316,44935,TC20,25150,25,25000,150
14470448,44985,TC20,29000,30,30000,-1000
14470448,44985,TC20,29000,,29000,0
14452625,44978,TC20,27650,28,28000,-350
14418185,44966,TC20,29000,30,30000,-1000
14529729,45009,TC20,32000,32,32000,0
14380403,44957,TC20,30880,30,30000,880
14354857,44942,TC20,31000,26,26000,5000
14432590,44970,TC20,26980,26,26000,980
14478974,44988,TC20,31880,31,31000,880
14511460,45001,TC20,27880,27,27000,880
14464462,44985,TC23,31000,31,31000,0
14408904,44966,TC20,29880,29,29000,880
14392258,44957,TC20,5000,32,32000,-27000
14432578,44970,TC20,9000,5,5000,4000
14432578,44970,TC20,9000,,9000,0
14470476,44986,TC23,32000,32,32000,0
14416836,44967,TC20,29880,29,29000,880
14331704,44929,TC20,32000,27,27000,5000
14446205,44974,TC20,5000,5,5000,0
14519288,45002,TC20,27440,28,28000,-560
14472502,44987,TC20,31880,32,32000,-120
14371230,44950,TC20,27180,27,27000,180
14507858,44999,TC20,27180,27,27000,180
14502143,44998,TC20,28880,28,28000,880
14331912,44931,TC23,32000,,32000,0
14331912,44931,TC23,32000,,32000,0
14513917,45002,TC23,33000,33,33000,0
14330964,44936,TC20,30880,30,30000,880
14397270,44958,TC23,32000,,32000,0
14397270,44958,TC23,32000,,32000,0
14404784,44963,TC23,33000,32,32000,1000
14502000,44995,TC23,26000,24,24000,2000
14502000,44995,TC23,26000,,26000,0
14452392,44978,TC23,27450,27,27000,450
14461486,44984,TC20,31820,31,31000,820
14421384,44967,TC20,28820,30,30000,-1180
14361072,44942,TC20,5000,5,5000,0
14441219,44978,TC20,28240,30,30000,-1760
14496475,44995,TC20,6000,6,6000,0
14427160,44973,TC20,28240,30,30000,-1760
14327113,44930,TC20,28240,,28240,0
14379738,44950,TC20,5000,5,5000,0
14380405,44957,TC20,28240,28,28000,240
14347485,44936,TC20,5000,5,5000,0
14503062,45001,TC20,28080,,28080,0
14503062,45001,TC20,28080,,28080,0
14469274,44984,TC26,6000,,6000,0
14469274,44984,TC26,6000,5,5000,1000
14487483,44992,TC20,5000,5,5000,0
14332971,44932,TC20,28240,,28240,0
14392225,44956,TC20,5000,5,5000,0
14420622,44967,TC20,28000,30,30000,-2000
14339514,44938,TC20,28040,28,28000,40
14475640,44999,TC20,28200,28,28000,200
14453565,44981,TC20,11000,5,5000,6000
14490459,44993,TC20,5000,5,5000,0
14490459,44993,TC20,5000,,5000,0
14362234,44943,TC20,27700,27,27000,700
14365183,44956,TC20,28180,28,28000,180
14432574,44971,TC20,11000,5,5000,6000
14460686,44981,TC20,28140,29,29000,-860
14497176,44994,TC20,6000,,6000,0
14497176,44994,TC20,6000,5,5000,1000
14497176,44994,TC20,6000,,6000,0
14452472,44979,TC20,5000,5,5000,0
14387313,44959,TC20,28240,28,28000,240
14432646,44971,TC20,21660,21,21000,660
14339370,44935,TC23,32000,32,32000,0
14474598,44986,TC20,33160,32,32000,1160
14418587,44965,TC20,32160,31,31000,1160
14533432,45008,TC20,8000,32,32000,-24000
14396699,44956,TC23,31600,25,25000,6600
14365163,44950,TC20,30160,31,31000,-840
14402990,44959,TC20,22910,22,22000,910
14529298,45007,TC20,27460,27,27000,460
14434595,44972,TC23,30000,30,30000,0
14498482,44995,TC20,32000,32,32000,0
14425692,44967,CON20,23040,26,26000,-2960
14464955,44981,TC20,5000,5,5000,0
14380419,44957,TC20,30220,30,30000,220
14481441,44988,TC20,26720,26,26000,720
14495000,44993,TC23,20000,20,20000,0
14490456,44993,TC20,23000,27,27000,-4000
14490456,44993,TC20,23000,,23000,0
14490456,44993,TC20,23000,,23000,0
14405698,44960,TC23,15000,15,15000,0
14418226,44966,TC23,15000,15,15000,0
14487583,44991,TC20,22000,22,22000,0
14487583,44991,TC20,22000,,22000,0
14493848,44994,TC20,23540,24,24000,-460
14443649,44974,TC20,5000,5,5000,0
14386414,44953,TC23,32000,32,32000,0
14381426,44950,TC23,33000,30,30000,3000
14444184,44977,TC20,32280,33,33000,-720
14416835,44967,TC20,30220,31,31000,-780
14357623,44942,TC20,5000,5,5000,0
14482418,45001,TC26,29000,29,29000,0
14511394,45005,TC26,29000,29,29000,0
14362064,44950,TC26,29000,29,29000,0
14398846,44963,TC30,6000,,6000,0
14398846,44963,TC30,6000,5,5000,1000
14471414,44987,TC20,5000,,5000,0
14471414,44987,TC20,5000,4,4000,1000
14380631,44958,TC26,29000,29,29000,0
14454490,44985,TC26,29000,29,29000,0
14408846,44963,TC20,32580,32,32000,580
14414174,44964,TC20,9000,4,4000,5000
14339661,44942,TC26,29000,29,29000,0
14490743,44993,TC20,30000,,30000,0
14490743,44993,TC20,30000,,30000,0
14490743,44993,TC20,30000,30,30000,0
14487398,44991,TC20,25000,,25000,0
14487398,44991,TC20,25000,27,27000,-2000
14388296,44956,TC20,5000,5,5000,0
14482421,44991,TC20,33000,33,33000,0
14389855,44953,TC23,33000,33,33000,0
14380418,44956,TC20,30360,31,31000,-640
14510067,45001,TC20,29000,29,29000,0
14510067,45001,TC20,29000,,29000,0
14510067,45001,TC20,29000,29,29000,0
14402271,44960,TC23,32000,32,32000,0
14492010,44994,TC23,23000,23,23000,0
14463804,44984,TC20,27200,27,27000,200
14392946,44957,TC23,30000,30,30000,0
14362912,44943,TC20,27200,28,28000,-800
14487865,44993,TC20,27200,30,30000,-2800
14419858,44965,TC23,30000,30,30000,0
14510349,45001,TC20,27200,27,27000,200
14418107,44965,TC23,30000,30,30000,0
14340182,44935,TC23,33000,28,28000,5000
14356833,44942,TC20,27200,27,27000,200
14524249,45006,TC20,27200,27,27000,200
14423397,44966,TC23,30000,30,30000,0
14372721,44949,TC20,27200,28,28000,-800
14440185,44973,TC20,27200,28,28000,-800
14531686,45008,TC20,27200,27,27000,200
14531647,45009,TC20,27200,,27200,0
14445802,44977,TC20,27200,27,27000,200
14379670,44949,TC20,27200,28,28000,-800
14402273,44960,TC26,32000,32,32000,0
14331913,44931,TC26,32000,32,32000,0
14458121,44986,TC20,28890,28,28000,890
14508394,44999,TC20,31000,27,27000,4000
14502817,44995,TC20,5000,,5000,0
14502817,44995,TC20,5000,5,5000,0
14401420,44959,TC20,5000,4,4000,1000
14461492,44985,TC20,31890,30,30000,1890
14470514,44984,TC20,28450,27,27000,1450
14529325,45007,TC20,5000,5,5000,0
14386616,44952,TC23,33000,30,30000,3000
14473016,44987,TC20,28890,28,28000,890
14417196,44967,TC23,32000,32,32000,0
14470677,44984,TC23,5001,4,4000,1001
14470677,44984,TC23,5001,,5001,0
14470677,44984,TC23,5001,,5001,0
14386615,44952,TC23,30000,30,30000,0
14473446,44987,TC23,33000,33,33000,0
14389587,44953,TC23,31000,31,31000,0
14337252,44935,TC20,31890,,31890,0
14341510,44939,TC20,31890,31,31000,890
14337256,44935,TC20,31890,,31890,0
14341514,44939,TC20,31890,32,32000,-110
14341514,44939,TC20,31890,,31890,0
14337257,44935,TC20,31890,,31890,0
14506450,45006,TC20,31890,32,32000,-110
14341515,44939,TC20,31890,31,31000,890
14341512,44939,TC20,31890,32,32000,-110
14341511,44939,TC20,31890,31,31000,890
14506374,44999,TC20,31890,32,32000,-110
14506448,45006,TC20,31890,32,32000,-110
14506427,45002,TC20,31890,32,32000,-110
14506451,45006,TC20,31890,32,32000,-110
14337255,44936,TC20,31890,,31890,0
14506372,44999,TC20,31890,31,31000,890
14341504,44939,TC20,31890,32,32000,-110
14341509,44939,TC20,31890,31,31000,890
14341508,44939,TC20,31890,31,31000,890
14337253,44935,TC20,31890,,31890,0
14341513,44939,TC20,31890,31,31000,890
14506449,45002,TC20,31890,31,31000,890
14341506,44939,TC20,31890,32,32000,-110
14506429,45006,TC20,31890,31,31000,890
14341507,44939,TC20,31890,31,31000,890
14506110,44998,TC20,5000,,5000,0
14506110,44998,TC20,5000,4,4000,1000
14529547,45008,TC20,5000,5,5000,0
14470443,44986,TC20,5000,5,5000,0
14444183,44977,TC20,5000,4,4000,1000
14342263,44936,TC20,5000,5,5000,0
14397660,44958,TC20,32680,31,31000,1680
14393050,44956,TC20,31680,32,32000,-320
14454975,44980,TC20,29680,30,30000,-320
14437828,44972,TC20,5000,4,4000,1000
14515713,45005,TC20,27680,28,28000,-320
14388838,44952,TC20,5000,4,4000,1000
14388558,44952,TC20,33140,28,28000,5140
14444139,44974,TC20,35000,29,29000,6000
14444139,44974,TC20,35000,,35000,0
14444139,44974,TC20,35000,,35000,0
14530756,45008,TC20,28680,30,30000,-1320
14509848,44999,TC20,32000,32,32000,0
14509848,44999,TC20,32000,,32000,0
14494425,44993,TC20,32000,,32000,0
14494425,44993,TC20,32000,,32000,0
14451587,44981,TC20,29680,30,30000,-320
14392778,44958,TC20,31780,30,30000,1780
14345750,44935,TC26,36000,31,31000,5000
14476711,44987,TC20,27690,30,30000,-2310
14388400,44956,TC20,31750,31,31000,750
14397521,44957,TC26,32000,32,32000,0
14508420,44999,TC20,32000,32,32000,0
14424874,44971,TC23,28000,30,30000,-2000
14494857,44993,TC20,33000,,33000,0
14494857,44993,TC20,33000,30,30000,3000
14487729,44992,TC20,28690,30,30000,-1310
14327201,44931,TC26,25000,25,25000,0
14351776,44939,TC26,32000,32,32000,0
14362700,44943,TC20,32690,33,33000,-310
14470463,44987,TC20,30000,30,30000,0
14403921,44960,TC20,32690,34,34000,-1310
14487691,44992,TC20,31690,31,31000,690
14369911,44945,TC20,5000,5,5000,0
14458128,44981,TC20,27690,27,27000,690
14529490,45008,TC26,30000,30,30000,0
14506390,45000,TC20,27690,27,27000,690
14404786,44963,TC26,28000,30,30000,-2000
14411969,44963,TC20,27790,25,25000,2790
14421554,44966,TC26,25950,25,25000,950
14488855,44991,TC20,26690,,26690,0
14488855,44991,TC20,26690,28,28000,-1310
14457701,44979,TC20,5000,5,5000,0
14488625,44991,TC20,28230,,28230,0
14488625,44991,TC20,28230,27,27000,1230
14351494,44937,TC20,37000,31,31000,6000
14404785,44963,TC26,25000,25,25000,0
14463909,44985,TC20,5000,4,4000,1000
14347452,44937,TC26,28000,28,28000,0
14381410,44952,TC26,28000,28,28000,0
14457401,44981,TC20,5000,5,5000,0
14510338,45005,TC20,30780,30,30000,780
14386778,44951,TC26,37000,31,31000,6000
14400178,44959,TC20,32900,34,34000,-1100
14408676,44964,TC20,32900,30,30000,2900
14508391,44999,TC20,35000,31,31000,4000
14479525,44988,TC26,30000,30,30000,0
14508403,44999,TC20,30000,28,28000,2000
14403197,44959,TC26,26000,26,26000,0
14424872,44971,TC20,25000,25,25000,0
14392657,44960,TC20,27380,27,27000,380
14471402,44986,TC20,5000,5,5000,0
14456675,44984,TC20,10000,,10000,0
14456675,44984,TC20,10000,4,4000,6000
14494987,45000,TC20,27080,,27080,0
14408560,44966,TC20,27380,27,27000,380
14454866,44988,TC20,27380,27,27000,380
14454903,44981,TC20,27180,27,27000,180
14525938,45005,TC20,5000,,5000,0
14525938,45005,TC20,5000,5,5000,0
14380867,44950,TC20,5000,5,5000,0
14386213,44951,TC26,28000,30,30000,-2000
14536901,45009,TC26,27680,28,28000,-320
14536901,45009,TC26,27680,,27680,0
14536901,45009,TC26,27680,,27680,0
14536901,45009,TC26,27680,,27680,0
14536901,45009,TC26,27680,,27680,0
14536901,45009,TC26,27680,,27680,0
14339726,44932,TC20,31180,30,30000,1180
14361536,44942,TC26,30000,30,30000,0
14478975,44988,TC20,32180,32,32000,180
14492045,44992,TC20,32180,,32180,0
14492045,44992,TC20,32180,30,30000,2180
14529297,45007,TC20,5000,4,4000,1000
14508398,44999,TC20,31000,28,28000,3000
14388940,44956,TC26,28000,28,28000,0
14479025,44987,TC20,24050,24,24000,50
14502768,44999,TC20,27180,27,27000,180
14404862,44959,TC26,32000,30,30000,2000
14348254,44942,TC20,31180,31,31000,180
14490283,44993,TC20,32180,32,32000,180
14469580,44986,TC20,28180,30,30000,-1820
14365102,44944,TC26,27000,27,27000,0
14326363,44936,TC20,28300,28,28000,300
14364791,44943,TC26,36000,31,31000,5000
14402303,44959,TC26,27727,28,28000,-273
14476714,44988,TC20,29180,29,29000,180
14347840,44936,TC26,26000,26,26000,0
14533017,45007,TC26,25260,,25260,0
14533017,45007,TC26,25260,25,25000,260
14427368,44973,TC20,31340,31,31000,340
14469581,44988,TC20,5000,4,4000,1000
14457513,44979,TC20,5000,4,4000,1000
14505930,44998,TC20,30180,30,30000,180
14495001,44994,TC26,14920,15,15000,-80
14525670,45006,TC20,28180,28,28000,180
14434594,44972,TC26,28000,28,28000,0
14490321,44994,TC20,27180,28,28000,-820
14332466,44938,TC20,31180,31,31000,180
14432596,44970,TC20,15180,17,17000,-1820
14427574,44970,TC26,25000,25,25000,0
14421655,44965,TC20,36000,31,31000,5000
14418227,44966,TC26,23000,23,23000,0
14452588,44978,TC20,14180,15,15000,-820
14339491,44935,TC26,32000,30,30000,2000
14521051,45006,TC26,32000,32,32000,0
14367565,44945,TC20,32180,32,32000,180
14487511,44992,TC20,28180,28,28000,180
14380402,44957,TC20,31180,32,32000,-820
14427075,44970,TC20,22180,22,22000,180
14349006,44938,TC26,28000,28,28000,0
14369156,44945,TC20,32710,27,27000,5710
14520686,45005,TC20,20260,21,21000,-740
14328481,44929,TC26,28000,28,28000,0
14347805,44937,TC26,29000,30,30000,-1000
14464552,44985,TC20,5000,4,4000,1000
14433550,44971,TC26,29000,30,30000,-1000
14337307,44931,TC20,31710,31,31000,710
14414778,44964,TC26,28000,30,30000,-2000
14469786,44988,TC20,31710,30,30000,1710
14401419,44959,TC20,38000,32,32000,6000
14401419,44959,TC20,38000,,38000,0
14396711,44956,TC26,33210,27,27000,6210
14452586,44978,TC20,5000,5,5000,0
14345419,44936,TC20,29710,30,30000,-290
14458122,44985,TC20,29710,31,31000,-1290
14437885,44973,TC20,24660,30,30000,-5340
14396170,44957,TC20,38000,31,31000,7000
14388837,44952,TC20,5000,4,4000,1000
14437830,44972,TC20,5000,4,4000,1000
14372902,44949,TC26,32000,32,32000,0
14463908,44985,TC20,28710,29,29000,-290
14455735,44981,TC26,29000,29,29000,0
14434542,44972,TC20,31710,31,31000,710
14326365,44928,TC20,29260,30,30000,-740
14515527,45001,TC20,28140,29,29000,-860
14362876,44944,TC26,33000,33,33000,0
14490284,44993,TC20,29640,30,30000,-360
14435743,44972,TC20,30640,31,31000,-360
14357668,44942,TC26,32000,32,32000,0
14361468,44942,TC20,30510,25,25000,5510
14441207,44977,TC20,31640,30,30000,1640
14362877,44944,TC26,28000,28,28000,0
14435764,44971,TC20,25640,26,26000,-360
14345457,44939,TC20,31640,31,31000,640
14403920,44960,TC20,32640,32,32000,640
14529324,45007,TC20,5000,5,5000,0
14462005,44984,TC26,28000,28,28000,0
14339439,44935,TC26,28000,28,28000,0
14452583,44978,TC20,5000,5,5000,0
14340214,44935,TC23,32000,32,32000,0
14508416,44999,TC23,30000,28,28000,2000
14512692,45002,TC20,28000,28,28000,0
14509984,45001,TC20,29000,29,29000,0
14520950,45005,TC20,5000,5,5000,0
14444108,44977,TC20,35000,29,29000,6000
14502731,44995,TC20,27000,,27000,0
14508499,45000,TC23,30000,27,27000,3000
14508499,45000,TC23,30000,,30000,0
14493847,44994,TC20,27940,28,28000,-60
14392169,44956,TC20,35000,30,30000,5000
14351341,44938,TC23,32000,32,32000,0
14490429,44993,TC20,27000,,27000,0
14490429,44993,TC20,27000,28,28000,-1000
14490429,44993,TC20,27000,,27000,0
14490429,44993,TC20,27000,,27000,0
14439656,44974,TC20,30020,30,30000,20
14336628,44931,TC20,31940,32,32000,-60
14439653,44973,TC20,29540,30,30000,-460
14345404,44937,TC20,14710,15,15000,-290
14508412,44999,TC20,33000,31,31000,2000
14418195,44965,TC26,28000,28,28000,0
14392960,44956,TC26,25000,25,25000,0
14414228,44965,TC26,28000,25,25000,3000
14508401,44999,TC20,31000,31,31000,0
14361398,44943,TC20,26210,26,26000,210
14420561,44966,TC26,14000,14,14000,0
14439654,44973,TC20,30710,30,30000,710
14369844,44946,TC26,25000,25,25000,0
14356648,44942,TC20,29710,29,29000,710
14365164,44950,TC20,31710,31,31000,710
14458598,44985,TC20,5000,4,4000,1000
14508405,44999,TC20,32000,30,30000,2000
14528633,45007,TC26,32000,31,31000,1000
14529322,45007,TC20,5000,5,5000,0
14328430,44931,TC20,28715,28,28000,715
14521218,45006,TC20,27715,28,28000,-285
14392921,44957,TC26,25250,26,26000,-750
14439655,44974,TC20,31515,31,31000,515
14421489,44974,TC26,31000,31,31000,0
14407743,44960,TC20,35000,28,28000,7000
14407743,44960,TC20,35000,,35000,0
14345217,44942,TC20,24875,25,25000,-125
14461155,44981,TC20,32715,32,32000,715
14368528,44946,TC20,30755,30,30000,755
14444895,44978,TC26,28000,28,28000,0
14487866,44991,TC20,32115,32,32000,115
14330987,44935,TC20,19715,20,20000,-285
14497030,44995,TC20,27715,28,28000,-285
14363125,44944,TC26,21000,21,21000,0
14375927,44951,TC20,5000,4,4000,1000
14353984,44942,TC26,36000,31,31000,5000
14353984,44942,TC26,36000,,36000,0
14353984,44942,TC26,36000,,36000,0
14400070,44959,TC26,30000,30,30000,0
14354789,44951,TC20,31815,30,30000,1815
14421390,44965,TC20,37000,32,32000,5000
14470175,44988,TC20,31715,32,32000,-285
14470175,44988,TC20,31715,,31715,0
14474668,44988,TC20,27715,27,27000,715
14438686,44972,TC20,5000,5,5000,0
14382263,44951,TC20,35000,35,35000,0
14506389,45001,TC20,27710,27,27000,710
14420839,44967,TC26,17000,17,17000,0
14420839,44967,TC26,17000,,17000,0
14440981,44974,TC26,32000,32,32000,0
14509680,44999,TC20,32710,,32710,0
14509680,44999,TC20,32710,31,31000,1710
14509680,44999,TC20,32710,30,30000,2710
14509680,44999,TC20,32710,31,31000,1710
14531560,45009,TC20,31950,32,32000,-50
14510065,45001,TC20,32000,32,32000,0
14507114,44998,TRA,32000,,32000,0
14507114,44998,TRA,32000,31,31000,1000
14328431,44929,TC20,31480,31,31000,480
14422695,44970,TC23,33000,31,31000,2000
14474667,44988,TC20,32020,33,33000,-980
14368763,44951,TC20,27030,27,27000,30
14491914,44994,TC20,31940,32,32000,-60
14454222,44984,TC20,31600,32,32000,-400
14380399,44950,TC20,5000,5,5000,0
14488060,44991,TC20,32980,33,33000,-20
14529611,45008,TC26,23000,23,23000,0
14378387,44949,TC20,33601,28,28000,5601
14396891,44963,TC26,25000,26,26000,-1000
14352653,44939,TC20,29600,29,29000,600
14362658,44950,TC20,31600,32,32000,-400
14380417,44950,TC20,5000,5,5000,0
14362708,44944,TC20,26600,26,26000,600
14362103,44942,SWAP20,18000,5,5000,13000
14347363,44936,SWAP20,18000,13,13000,5000
14375617,44946,SWAP20,18000,4,4000,14000
14388536,44952,SWAP20,18000,4,4000,14000
14416902,44964,SWAP20,15000,8,8000,7000
14402944,44958,SWAP20,18000,9,9000,9000
14490286,44992,SWAP20,15000,8,8000,7000
14507826,44998,SWAP20,15000,13,13000,2000
14520238,45002,SWAP20,15000,,15000,0
14520238,45002,SWAP20,15000,6,6000,9000
14446147,44974,SWAP20,15000,10,10000,5000
14434087,44970,SWAP20,15000,7,7000,8000
14475644,44986,SWAP20,13500,8,8000,5500
14460709,44980,SWAP20,15000,6,6000,9000
14535540,45008,SWAP20,15000,5,5000,10000
14331910,44929,SW20,18000,,18000,0
14331910,44929,SW20,18000,5,5000,13000
14331910,44929,SW20,18000,,18000,0
14350671,44937,SW20,18000,7,7000,11000
14364335,44943,SWAP20,18000,7,7000,11000
14405378,44959,SWAP20,15000,5,5000,10000
14419750,44965,SWAP20,15000,3,3000,12000
14392375,44953,SWAP20,18000,4,4000,14000
14380350,44949,SWAP20,18000,5,5000,13000
14463942,44981,SWAP20,15000,11,11000,4000
14477943,44987,SWAP20,15000,5,5000,10000
14435657,44971,SWAP20,15000,7,7000,8000
14451250,44977,SWAP20,15000,8,8000,7000
14513120,45000,SWAP20,15000,6,6000,9000
14513120,45000,SWAP20,15000,,15000,0
14493390,44993,SWAP20,15000,11,11000,4000
14527900,45006,SWAP20,15000,9,9000,6000
14482326,44988,SWAP20,15000,15,15000,0
14517022,45001,SWAP20,15000,7,7000,8000
14502794,44995,SWAP20,15000,5,5000,10000
14453996,44978,SWAP20,15000,10,10000,5000
14439261,44972,SWAP20,15000,6,6000,9000
14469448,44984,SWAP20,15000,15,15000,0
14382293,44950,SWAP20,18000,,18000,0
14382293,44950,SWAP20,18000,5,5000,13000
14396118,44956,SWAP20,18000,5,5000,13000
14422943,44966,SWAP20,15000,5,5000,10000
14408288,44960,SWAP20,15000,10,10000,5000
14367919,44944,SWAP20,18000,4,4000,14000
14353103,44938,SWAP20,18000,7,7000,11000
14336293,44930,SWAP20,18000,7,7000,11000
14345102,44935,SWAP20,18000,4,4000,14000
14330176,44928,SWAP20,18000,7,7000,11000
14357415,44939,SWAP20,18000,5,5000,13000
14371190,44945,SWAP20,18000,6,6000,12000
14399771,44957,SWAP20,18000,9,9000,9000
14413278,44963,SWAP20,15000,13,13000,2000
14386425,44951,SWAP20,18000,6,6000,12000
14471741,44985,SWAP20,15000,9,9000,6000
14456952,44979,SWAP20,15000,3,3000,12000
14426801,44967,SWAP20,15000,4,4000,11000
14442406,44973,SWAP20,15000,6,6000,9000
14510522,44999,SWAP20,15000,,15000,0
14510522,44999,SWAP20,15000,8,8000,7000
14488355,44991,SWAP20,15000,8,8000,7000
14524466,45005,SWAP20,15000,6,6000,9000
14524466,45005,SWAP20,15000,6,6000,9000
14537661,45009,SWAP20,15000,,15000,0
14353431,44938,TRA,15000,8,8000,7000
14445002,44974,TRA,16000,30,30000,-14000
14531658,45007,TRA,8000,11,11000,-3000
14515529,45001,TRA,25000,28,28000,-3000
14474323,44986,TRA,20000,19,19000,1000
14524465,45005,TRA,20000,11,11000,9000
14400157,44957,TRA,27000,,27000,0
14400157,44957,TRA,27000,23,23000,4000
14400150,44958,TRA,32000,18,18000,14000
14356820,44939,TRA,31000,26,26000,5000
14332434,44929,TRA,15000,8,8000,7000
14400993,44958,TRA,18000,19,19000,-1000
14481573,44988,TRA,25000,25,25000,0
14413970,44963,TRA,8000,8,8000,0
14367604,44944,TRA,15000,15,15000,0
14350601,44937,TRA,15000,7,7000,8000
14525488,45006,TRA,20000,,20000,0
14525488,45006,TRA,20000,32,32000,-12000
14525488,45006,TRA,20000,,20000,0
14356824,44939,TRA,31000,20,20000,11000
14408032,44960,TRA,24000,24,24000,0
14514827,45000,TRA,7000,7,7000,0
14468534,44984,TRA,24000,20,20000,4000
14396713,44957,TRA,15000,11,11000,4000
14405370,44959,TRA,8000,8,8000,0
14510158,44999,TRA,25000,27,27000,-2000
14391892,44953,TRA,15000,7,7000,8000
14481597,44988,TRA,20000,25,25000,-5000
14457674,44979,TRA,7000,7,7000,0
14444092,44973,TRA,8000,7,7000,1000
14416379,44964,TRA,16000,14,14000,2000
14479029,44987,TRA,7000,7,7000,0
14519297,45002,TRA,25000,25,25000,0
14426394,44967,TRA,14000,14,14000,0
14505971,44998,TRA,20000,29,29000,-9000
14505971,44998,TRA,20000,,20000,0
14353432,44938,TRA,15000,8,8000,7000
14537662,45009,TRA,7000,,7000,0
14478987,44987,TRA,7000,30,30000,-23000
14338132,44930,TRA,15000,7,7000,8000
14524647,45005,TRA,13000,30,30000,-17000
14482648,44988,TRA,35000,18,18000,17000
14520249,45002,TRA,35000,20,20000,15000
14520249,45002,TRA,35000,,35000,0
14486882,44991,TRA,20000,18,18000,2000
14482939,44988,TRA,20000,30,30000,-10000
14443255,44973,TRA,7000,7,7000,0
14420754,44965,TRA,15000,7,7000,8000
14347577,44936,TRA,15000,7,7000,8000
14458618,44979,TRA,7000,10,10000,-3000
14390945,44953,TRA,32000,24,24000,8000
14345963,44935,TRA,35000,16,16000,19000
14339403,44931,TRA,15000,8,8000,7000
14346182,44936,TRA,32000,25,25000,7000
14346158,44935,TRA,27000,16,16000,11000
14419850,44965,TRA,21000,31,31000,-10000
14531017,45007,TRA,18000,18,18000,0
14422160,44966,TRA,20000,22,22000,-2000
14505939,44998,TRA,25000,25,25000,0
14468571,44984,TRA,20000,17,17000,3000
14462385,44980,TRA,7000,8,8000,-1000
14380364,44949,TRA,15000,8,8000,7000
14469333,44984,TRA,7000,8,8000,-1000
14391023,44956,TRA,27000,22,22000,5000
14441709,44973,TRA,25000,26,26000,-1000
14475759,44986,TRA,7000,7,7000,0
14382082,44950,TRA,27000,20,20000,7000
14392940,44956,TRA,32000,24,24000,8000
14453010,44978,TRA,27000,22,22000,5000
14506212,44998,TRA,24000,27,27000,-3000
14506212,44998,TRA,24000,,24000,0
14338154,44930,TRA,15000,7,7000,8000
14487900,44991,TRA,8000,8,8000,0
14381345,44950,TRA,22000,14,14000,8000
14507822,44998,TRA,16000,,16000,0
14507822,44998,TRA,16000,22,22000,-6000
14389274,44952,TRA,15000,7,7000,8000
14471740,44985,TRA,8000,8,8000,0
14386318,44951,TRA,15000,15,15000,0
14490707,44992,TRA,20000,18,18000,2000
14490707,44992,TRA,20000,,20000,0
14527537,45006,TRA,25000,23,23000,2000
14481607,44988,TRA,24000,28,28000,-4000
14436522,44971,TRA,8000,8,8000,0
14345160,44935,TRA,15000,7,7000,8000
14475668,44986,TRA,7000,7,7000,0
14475668,44986,TRA,7000,6,6000,1000
14495974,44994,TRA,25000,27,27000,-2000
14423029,44966,TRA,8000,8,8000,0
14534731,45008,TRA,8000,8,8000,0
14386067,44951,TRA,15000,7,7000,8000
14495978,44994,TRA,18000,18,18000,0
14533413,45008,TRA,20000,,20000,0
14533413,45008,TRA,20000,27,27000,-7000
14471814,44985,TRA,8000,8,8000,0
14485394,44991,TRA,20000,20,20000,0
14445488,44974,TRA,16000,12,12000,4000
14340769,44935,TRA,27000,24,24000,3000
14475723,44986,TRA,8000,7,7000,1000
14446491,44974,TRA,8000,10,10000,-2000
14471794,44985,TRA,8000,8,8000,0
14489989,44992,TRA,12000,10,10000,2000
14363200,44943,TRA,29000,25,25000,4000
14493990,44993,TRA,35000,28,28000,7000
14475781,44986,TRA,31000,22,22000,9000
14454381,44978,TRA,7000,6,6000,1000
14389275,44952,TRA,15000,10,10000,5000
14350599,44937,TRA,15000,7,7000,8000
14534382,45008,TRA,8000,8,8000,0
14464668,44981,TRA,7000,7,7000,0
14369781,44945,TRA,27000,27,27000,0
14381349,44950,TRA,32000,19,19000,13000
14416380,44964,TRA,20000,21,21000,-1000
14375223,44946,TRA,15000,7,7000,8000
14519301,45002,TRA,18000,,18000,0
14519301,45002,TRA,18000,25,25000,-7000
14424356,44966,TRA,20000,20,20000,0
14520215,45002,TRA,8000,15,15000,-7000
14520215,45002,TRA,8000,10,10000,-2000
14345164,44935,TRA,15000,7,7000,8000
14459979,44980,TRA,12000,12,12000,0
14382724,44950,TRA,15000,8,8000,7000
14512891,45000,TRA,35000,32,32000,3000
14491791,44992,TRA,35000,17,17000,18000
14531699,45007,TRA,35000,20,20000,15000
14332436,44929,TRA,15000,8,8000,7000
14413973,44963,TRA,8000,7,7000,1000
14433572,44970,TRA,35000,8,8000,27000
14427443,44967,TRA,15000,10,10000,5000
14453011,44978,TRA,32000,21,21000,11000
14396871,44956,TRA,15000,8,8000,7000
14439232,44972,TRA,12000,17,17000,-5000
14463598,44981,TRA,15000,8,8000,7000
14528708,45006,TRA,8000,7,7000,1000
14474586,44986,TRA,14000,,14000,0
14474586,44986,TRA,14000,9,9000,5000
14510167,44999,TRA,8000,8,8000,0
14408499,44960,TRA,8000,7,7000,1000
14408270,44963,TRA,24000,28,28000,-4000
14490981,44992,TRA,8000,8,8000,0
14338125,44930,TRA,15000,7,7000,8000
14525526,45005,TRA,7000,7,7000,0
14426087,44967,TRA,20000,21,21000,-1000
14502029,44995,TRA,8000,,8000,0
14502029,44995,TRA,8000,6,6000,2000
14494389,44993,TRA,8000,8,8000,0
14415018,44963,TRA,20000,17,17000,3000
14346147,44935,TRA,32000,30,30000,2000
14330633,44928,TRA,15000,7,7000,8000
14382722,44950,TRA,15000,7,7000,8000
14497245,44994,TRA,14000,10,10000,4000
14516942,45001,TRA,35000,16,16000,19000
14534417,45008,TRA,35000,13,13000,22000
14375234,44946,TRA,15000,6,6000,9000
14340770,44935,TRA,27000,31,31000,-4000
14339332,44931,TRA,15000,7,7000,8000
14509812,44999,TRA,13000,10,10000,3000
14509812,44999,TRA,13000,,13000,0
14450708,44977,TRA,24000,21,21000,3000
14470749,44985,TRA,18000,17,17000,1000
14470749,44985,TRA,18000,18,18000,0
14347579,44936,TRA,15000,7,7000,8000
14523491,45005,TRA,26000,22,22000,4000
14450508,44977,TRA,20000,19,19000,1000
14432600,44970,TRA,24000,21,21000,3000
14432600,44970,TRA,24000,,24000,0
14432659,44971,TRA,20000,21,21000,-1000
14537683,45009,TRA,7000,7,7000,0
14457686,44979,TRA,12000,10,10000,2000
14487984,44991,TRA,20000,14,14000,6000
14487984,44991,TRA,20000,,20000,0
14487863,44991,TRA,35000,33,33000,2000
14507161,44998,TRA,34000,28,28000,6000
14469342,44984,TRA,35000,28,28000,7000
14527896,45006,TRA,35000,18,18000,17000
14451752,44977,TRA,7000,8,8000,-1000
14387933,44952,TRA,27000,28,28000,-1000
14433030,44970,TRA,20000,12,12000,8000
14537572,45009,TRA,25000,19,19000,6000
14517290,45001,TRA,25000,,25000,0
14517290,45001,TRA,25000,30,30000,-5000
14525531,45005,TRA,7000,7,7000,0
14433584,44970,TRA,24000,24,24000,0
14386487,44951,TRA,15000,7,7000,8000
14373290,44946,TRA,25000,20,20000,5000
14477513,44987,TRA,20000,,20000,0
14477513,44987,TRA,20000,,20000,0
14477513,44987,TRA,20000,27,27000,-7000
14514735,45000,TRA,8000,,8000,0
14360322,44942,TRA,25000,18,18000,7000
14501520,44995,TRA,20000,16,16000,4000
14501520,44995,TRA,20000,,20000,0
14510362,44999,TRA,23000,,23000,0
14510362,44999,TRA,23000,20,20000,3000
14350602,44937,TRA,15000,7,7000,8000
14400998,44958,TRA,31000,31,31000,0
14439601,44972,TRA,8000,7,7000,1000
14439601,44972,TRA,8000,,8000,0
14360994,44942,TRA,27000,29,29000,-2000
14363187,44942,TRA,32000,30,30000,2000
14352610,44942,TRA,32000,,32000,0
14352610,44942,TRA,32000,,32000,0
14387930,44952,TRA,32000,18,18000,14000
14435740,44974,CON30,4000,4,4000,0
14435739,44974,CON30,4000,4,4000,0
14364956,44946,CON30,4000,4,4000,0
14521183,45002,CON40,4000,4,4000,0
14454098,44978,TRA,31000,30,30000,1000
14372098,44945,TRA,27000,19,19000,8000
14533802,45008,TRA,19500,,19500,0
14509854,44999,TRA,35000,,35000,0
14509854,44999,TRA,35000,,35000,0
14509854,44999,TRA,35000,35,35000,0
14533804,45008,TRA,15900,,15900,0
14533735,45008,TRA,18500,,18500,0
14404524,44959,TRA,17000,13,13000,4000
14528410,45006,TRA,25000,,25000,0
14528410,45006,TRA,25000,,25000,0
14528410,45006,TRA,25000,20,20000,5000
14533808,45008,TRA,15900,,15900,0
14434152,44970,TRA,25000,30,30000,-5000
14457575,44979,TRA,31000,25,25000,6000
14507141,44998,TRA,15000,,15000,0
14507141,44998,TRA,15000,,15000,0
14507141,44998,TRA,15000,14,14000,1000
14516355,45001,TRA,32000,34,34000,-2000
14516355,45001,TRA,32000,,32000,0
14507142,44998,TRA,10000,,10000,0
14507142,44998,TRA,10000,12,12000,-2000
14514082,45001,TRA,32000,32,32000,0
14389234,44952,TRA,36000,30,30000,6000
14440103,44972,TRA,11000,,11000,0
14468595,44984,TRA,11000,12,12000,-1000
14401421,44958,TRA,38000,24,24000,14000
14375729,44946,TRA,31000,27,27000,4000
14375729,44946,TRA,31000,,31000,0
14407503,44962,TRA,12000,12,12000,0
14487337,44991,TRA,20000,,20000,0
14487337,44991,TRA,20000,13,13000,7000
14401407,44958,TRA,21000,12,12000,9000
14463952,44985,TRA,20000,17,17000,3000
14338701,44935,TRA,18000,12,12000,6000
14481417,44988,TRA,9000,9,9000,0
14404590,44960,TRA,18000,12,12000,6000
14444195,44973,TRA,38000,,38000,0
14444195,44973,TRA,38000,,38000,0
14444195,44973,TRA,38000,30,30000,8000
14446962,44978,TRA,18000,12,12000,6000
14528412,45006,TRA,20000,12,12000,8000
14528412,45006,TRA,20000,,20000,0
14528412,45006,TRA,20000,,20000,0
14369407,44945,TRA,34000,24,24000,10000
14409148,44960,TRA,31000,23,23000,8000
14508326,44999,TRA,20000,,20000,0
14508326,44999,TRA,20000,20,20000,0
14512197,45000,TRA,32000,,32000,0
14512197,45000,TRA,32000,,32000,0
14519389,45002,TRA,7000,,7000,0
14519389,45002,TRA,7000,10,10000,-3000
14519389,45002,TRA,7000,,7000,0
14519389,45002,TRA,7000,10,10000,-3000
14370656,44946,TRA,25000,18,18000,7000
14357870,44942,TRA,31000,13,13000,18000
14528377,45006,TRA,10500,,10500,0
14528377,45006,TRA,10500,10,10000,500
14533739,45008,TRA,17500,,17500,0
14528388,45006,TRA,9500,10,10000,-500
14528388,45006,TRA,9500,,9500,0
14367326,44944,TRA,27000,28,28000,-1000
14464843,44981,TRA,12000,16,16000,-4000
14533762,45008,TRA,24500,,24500,0
14352664,44937,TRA,42000,33,33000,9000
14502767,44999,CON45,4500,4,4000,500
14393109,44957,CON45,5000,,5000,0
14372152,44952,CON45,5000,5,5000,0
14369661,44950,CON45,4500,5,5000,-500
14393110,44958,CON45,4500,6,6000,-1500
14352535,44939,CON45,4500,4,4000,500
14494405,44995,CON45,4500,4,4000,500
14340751,44936,CON45,4500,5,5000,-500
14415178,44965,CON45,4500,4,4000,500
14337364,44935,CON45,4500,6,6000,-1500
14493989,44993,TRA,30000,30,30000,0
14531794,45007,TRA,35000,20,20000,15000
14527898,45006,TRA,35000,25,25000,10000
14497331,44994,TRA,14000,12,12000,2000
14478989,44987,TRA,7000,31,31000,-24000
14414221,44966,CON45,4500,6,6000,-1500
14518237,45008,CON45,4500,7,7000,-2500
14520110,45002,CON45,4500,4,4000,500
14340189,44935,CON45,4500,6,6000,-1500
14354728,44942,CON45,4500,5,5000,-500
14365138,44949,CON45,4500,4,4000,500
14332338,44937,CON45,4500,4,4000,500
14436585,44971,CON45,4500,7,7000,-2500
14305447,44939,CON45,4500,4,4000,500
14305447,44939,CON45,4500,,4500,0
14406226,44972,CON45,4500,4,4000,500
14390341,44963,CON45,4500,6,6000,-1500
14372687,44957,CON45,4500,5,5000,-500
14331717,44930,CON45,4500,6,6000,-1500
14404886,44964,CON45,4500,6,6000,-1500
14404886,44964,CON45,4500,,4500,0
14340831,44943,CON45,4500,5,5000,-500
14413919,44964,CON45,4500,4,4000,500
14364767,44949,CON45,4500,5,5000,-500
14476699,44991,CON45,4500,4,4000,500
14482427,44999,CON45,4500,4,4000,500
14358283,44942,CON45,4500,6,6000,-1500
14438084,44976,CON45,4500,4,4000,500
14318825,44971,CON45,13000,13,13000,0
14364674,44949,CON45,4500,4,4000,500
14463651,44992,CON45,4500,4,4000,500
14499022,45002,CON45,4500,6,6000,-1500
14499022,45002,CON45,4500,,4500,0
14521001,45007,CON45,4500,4,4000,500
14366563,44951,CON45,4500,6,6000,-1500
14326610,44928,CON45,4500,5,5000,-500
14346011,44936,CON45,13000,5,5000,8000
14380215,44950,CON45,4500,6,6000,-1500
14423598,44971,CON45,4500,6,6000,-1500
14518224,45006,CON45,4500,4,4000,500
14507187,44998,TRA,31000,21,21000,10000
14464751,44981,TRA,31000,22,22000,9000
14415044,44965,TC20,5000,5,5000,0
14421445,44966,TC20,5000,5,5000,0
14391820,44953,TC20,5000,5,5000,0
14491128,44994,TC20,5000,5,5000,0
14391821,44953,TC20,5000,5,5000,0
14375541,44950,TC40,31000,31,31000,0
14458504,44979,TC40,26600,26,26000,600
14373388,44946,TC40,35000,32,32000,3000
14347803,44937,TC40,35000,32,32000,3000
14516763,45007,TC40,27600,30,30000,-2400
14526269,45008,TC40,28100,,28100,0
14526269,45008,TC40,28100,,28100,0
14403031,44958,TC40,32000,31,31000,1000
14434659,44972,TC40,29600,30,30000,-400
14427385,44970,TC40,7000,3,3000,4000
14472258,44991,TC40,30600,31,31000,-400
14406246,44960,TC40,29600,30,30000,-400
14406223,44959,TC40,7000,3,3000,4000
14333056,44931,TC40,35000,35,35000,0
14482532,44993,TC40,28100,30,30000,-1900
14387174,44953,CON40,31000,31,31000,0
14520418,45007,TC40,29600,29,29000,600
14472259,44991,TC40,27600,28,28000,-400
14421460,44967,TC40,30600,31,31000,-400
14443445,44973,TRA,32000,,32000,0
14443445,44973,TRA,32000,,32000,0
14443445,44973,TRA,32000,25,25000,7000
14446676,44974,TRA,24000,10,10000,14000
14482339,44988,TRA,29000,,29000,0
14482339,44988,TRA,29000,27,27000,2000
14482332,44988,KTA,25000,18,18000,7000
14501241,44995,KTA,25000,,25000,0
14501241,44995,KTA,25000,,25000,0
14501241,44995,KTA,25000,20,20000,5000
14507810,44998,KTA,20000,20,20000,0
14524467,45005,KTA,25000,16,16000,9000
14524467,45005,KTA,25000,,25000,0
14524467,45005,KTA,25000,,25000,0
14494402,44993,TRA,36000,35,35000,1000
14494402,44993,TRA,36000,36,36000,0
14442239,44973,TRA,25000,14,14000,11000
14472379,44985,TRA,28000,14,14000,14000
14425138,44966,TRA,34000,17,17000,17000
14405375,44959,TRA,8000,8,8000,0
14360323,44942,TRA,32000,22,22000,10000
14423030,44966,TRA,8000,7,7000,1000
14378392,44949,TRA,27000,23,23000,4000
14515539,45001,TRA,20000,,20000,0
14515539,45001,TRA,20000,30,30000,-10000
14439982,44972,TRA,8000,7,7000,1000
14361051,44943,TRA,31000,17,17000,14000
14505947,44998,TRA,20000,21,21000,-1000
14463940,44981,TRA,20000,23,23000,-3000
14463940,44981,TRA,20000,,20000,0
14444193,44974,TC20,38000,31,31000,7000
14444193,44974,TC20,38000,,38000,0
14444193,44974,TC20,38000,,38000,0
14444193,44974,TC20,38000,,38000,0
14330864,44930,TC20,36000,31,31000,5000
14382291,44951,TC20,36000,30,30000,6000
14382291,44951,TC20,36000,,36000,0
14416665,44971,TC20,32000,32,32000,0
14366413,44950,TC20,31980,32,32000,-20
14453961,44986,TC20,32000,32,32000,0
14490309,45002,TC20,31980,32,32000,-20
14437621,44979,TC20,32000,30,30000,2000
14470473,44994,TC20,32000,32,32000,0
14333040,44943,TC20,32000,32,32000,0
14382898,44958,TC20,32000,30,30000,2000
14413180,44967,TC20,30000,30,30000,0
14397282,44965,TC20,32000,32,32000,0
14333043,44944,TC20,32000,32,32000,0
14453959,44985,TC20,32000,32,32000,0
14508557,45006,TC20,32000,30,30000,2000
14330795,44929,TC20,5000,4,4000,1000
14420425,44970,TC20,31400,31,31000,400
14384089,44956,TC20,31400,31,31000,400
14367396,44949,TC20,36000,32,32000,4000
14330312,44929,TC20,31400,31,31000,400
14330312,44929,TC20,31400,,31400,0
14509693,44999,TC20,32000,32,32000,0
14509693,44999,TC20,32000,,32000,0
14506854,45002,TC20,31390,31,31000,390
14330869,44931,TC20,36000,32,32000,4000
14382289,44951,TC20,36000,,36000,0
14382289,44951,TC20,36000,30,30000,6000
14336499,44935,TC20,36000,31,31000,5000
14367394,44949,TC20,36000,32,32000,4000
14336501,44935,TC20,36000,31,31000,5000
14368284,44946,TC20,31400,31,31000,400
14408524,44966,TC20,31400,33,33000,-1600
14531414,45007,TC20,32000,31,31000,1000
14531414,45007,TC20,32000,,32000,0
14531414,45007,TC20,32000,,32000,0
14354794,44943,TC20,36000,,36000,0
14354794,44943,TC20,36000,31,31000,5000
14339187,44939,TC20,31400,31,31000,400
14386348,44953,TC20,31400,32,32000,-600
14347600,44937,TC20,36000,33,33000,3000
14469585,44985,TC20,33000,32,32000,1000
14330787,44929,TC20,5000,4,4000,1000
14329757,44928,TC20,5000,2,2000,3000
14351520,44939,CON20,33000,32,32000,1000
14414256,44964,TC20,36000,31,31000,5000
14454996,44980,TC20,37000,31,31000,6000
14329748,44928,TC20,5000,2,2000,3000
14329751,44928,TC20,5000,2,2000,3000
14469419,44984,TC20,5000,5,5000,0
14330804,44929,TC20,5000,3,3000,2000
14330798,44929,TC20,5000,3,3000,2000
14426883,44970,TC20,5000,5,5000,0
14427272,44971,TC20,5000,5,5000,0
14426885,44970,TC20,5000,5,5000,0
14426880,44970,TC20,5000,5,5000,0
14517098,45001,TC20,5000,4,4000,1000
14329750,44928,TC20,5000,2,2000,3000
14329750,44928,TC20,5000,,5000,0
14426886,44970,TC20,5000,5,5000,0
14427275,44971,TC20,5000,5,5000,0
14427270,44971,TC20,5000,4,4000,1000
14427271,44971,TC20,5000,5,5000,0
14516415,45001,TC20,5000,3,3000,2000
14329749,44928,TC20,5000,2,2000,3000
14490465,44995,TC20,35290,31,31000,4290
14470470,44992,TC20,32000,32,32000,0
14325057,44929,TC20,32000,32,32000,0
14366415,44952,TC20,31960,30,30000,1960
14416670,44973,TC20,32000,30,30000,2000
14347412,44946,TC20,35350,32,32000,3350
14490311,45000,TC20,32000,32,32000,0
14508555,45007,TC20,32000,32,32000,0
14453962,44987,TC20,32000,32,32000,0
14416667,44972,TC20,31960,31,31000,960
14347410,44945,TC20,32000,32,32000,0
14490310,45000,TC20,32000,32,32000,0
14437609,44978,TC20,32000,32,32000,0
14470472,44993,TC20,32000,32,32000,0
14325054,44930,TC20,31960,31,31000,960
14330788,44928,TC20,5000,4,4000,1000
14472217,44986,CON20,3500,4,4000,-500
14460912,44984,TC20,36530,35,35000,1530
14330404,44931,TC20,35130,31,31000,4130
14370108,44950,TC20,33020,36,36000,-2980
14337288,44935,TC20,35510,30,30000,5510
14414097,44965,TC20,30490,30,30000,490
14374462,44951,TC20,33000,36,36000,-3000
14397501,44959,TC20,31280,31,31000,280
14330797,44929,TC20,5000,3,3000,2000
14480064,44991,TC20,31280,31,31000,280
14508559,45007,TC20,32000,30,30000,2000
14453964,44986,TC20,31960,31,31000,960
14366414,44951,TC20,31960,32,32000,-40
14416666,44971,TC20,32000,30,30000,2000
14357748,44942,TC20,36000,31,31000,5000
14366416,44952,TC20,31980,32,32000,-20
14325060,44929,TC20,35260,32,32000,3260
14416669,44973,TC20,32000,31,31000,1000
14470468,44992,TC20,32000,32,32000,0
14453963,44985,TC20,32000,30,30000,2000
14508556,45006,TC20,32000,32,32000,0
14397280,44967,TC20,32000,32,32000,0
14366412,44950,TC20,31980,32,32000,-20
14333039,44943,TC20,32000,32,32000,0
14397278,44964,TC20,32000,32,32000,0
14490312,44999,TC20,32000,32,32000,0
14437622,44980,TC20,32000,32,32000,0
14426600,44971,TC20,38000,31,31000,7000
14437610,44979,TC20,32000,30,30000,2000
14470471,44995,TC20,32000,31,31000,1000
14382894,44958,TC20,32000,32,32000,0
14325055,44931,TC20,31960,32,32000,-40
14325058,44930,TC20,31940,32,32000,-60
14366411,44951,TC20,31980,30,30000,1980
14416668,44972,TC20,31980,31,31000,980
14453965,44987,TC20,32000,32,32000,0
14437623,44980,TC20,32000,32,32000,0
14490313,44999,TC20,32000,32,32000,0
14397281,44965,TC20,32000,32,32000,0
14333042,44944,TC20,31960,32,32000,-40
14325056,44931,TC20,32000,32,32000,0
14437612,44978,TC20,31960,32,32000,-40
14470467,44993,TC20,32000,30,30000,2000
14330807,44929,TC20,5000,3,3000,2000
14512999,45000,TC20,5000,3,3000,2000
14357751,44942,TC20,36000,32,32000,4000
14516459,45005,TC20,35260,31,31000,4260
14346145,44937,TC20,31280,31,31000,280
14330793,44928,TC20,5000,3,3000,2000
14351509,44938,TC20,36000,30,30000,6000
14414207,44963,TC20,38000,31,31000,7000
14371337,44949,TC20,31280,31,31000,280
14330725,44931,TC20,31280,30,30000,1280
14473538,44987,TC20,30400,30,30000,400
14461010,44987,TC20,30420,30,30000,420
14461009,44986,TC20,30400,31,31000,-600
14461011,44986,TC20,30400,31,31000,-600
14526275,45009,TC20,30500,30,30000,500
14480098,44991,TC20,30440,31,31000,-560
14483318,44992,TC20,30400,30,30000,400
14516301,45008,TC20,30400,30,30000,400
14488326,44993,TC20,30400,31,31000,-600
14491913,44995,TC20,30400,31,31000,-600
14497096,44998,TC20,30380,30,30000,380
14502471,44999,TC20,30560,30,30000,560
14502769,44999,TC20,30400,30,30000,400
14508474,45001,TC20,30650,31,31000,-350
14508476,45002,TC20,30400,31,31000,-600
14516296,45005,TC20,30520,30,30000,520
14516298,45005,TC20,30520,,30520,0
14516298,45005,TC20,30520,31,31000,-480
14329742,44928,TC20,5000,2,2000,3000
14329741,44928,TC20,5000,2,2000,3000
14329754,44928,TC20,5000,2,2000,3000
14329755,44928,TC20,5000,2,2000,3000
14517084,45001,TC20,5000,4,4000,1000
14516406,45001,TC20,5000,4,4000,1000
14329745,44928,TC20,5000,2,2000,3000
14330800,44929,TC20,5000,3,3000,2000
14330801,44929,TC20,5000,3,3000,2000
14403954,44960,TC20,31310,30,30000,1310
14513076,45000,TC20,5000,3,3000,2000
14460943,44985,TC20,30000,29,29000,1000
14460943,44985,TC20,30000,,30000,0
14414127,44963,TC20,38000,31,31000,7000
14450490,44977,TC20,5000,4,4000,1000
14450497,44977,TC20,5000,4,4000,1000
14390958,44956,TC20,8540,4,4000,4540
14390958,44956,TC20,8540,4,4000,4540
14453024,44978,TC20,8540,3,3000,5540
14453025,44978,TC20,8540,4,4000,4540
14348301,44937,TC20,24200,,24200,0
14348301,44937,TC20,24200,,24200,0
14349235,44937,TC20,24200,24,24000,200
14438942,44973,TC20,24200,25,25000,-800
14439945,44973,TC20,24200,24,24000,200
14391012,44956,TC20,8540,5,5000,3540
14523496,45005,TC20,5000,4,4000,1000
14523497,45005,TC20,5000,4,4000,1000
14525479,45005,TC20,5000,5,5000,0
14525479,45005,TC20,5000,,5000,0
14396717,44957,TC23,8540,5,5000,3540
14482862,44988,TC20,5000,5,5000,0
14405388,44959,TC20,9000,4,4000,5000
14419791,44967,TC20,30740,30,30000,740
14396565,44958,TC20,36740,31,31000,5740
14506632,45000,TC20,36760,36,36000,760
14441265,44977,TC20,36780,32,32000,4780
14475591,44988,TC20,36700,36,36000,700
14495180,44995,TC20,36640,31,31000,5640
14510576,45002,TC20,33020,33,33000,20
14478961,44991,TC20,36820,30,30000,6820
14330742,44938,TC20,30740,31,31000,-260
14424827,44970,TC20,36800,31,31000,5800
14436514,44973,TC20,30780,30,30000,780
14402025,44960,TC20,30740,30,30000,740
14399810,44959,TC20,32980,30,30000,2980
14452170,44979,TC20,36780,31,31000,5780
14516299,45006,TC20,30740,30,30000,740
14482433,44992,TC20,36820,36,36000,820
14393256,44957,TC20,36720,36,36000,720
14322888,44928,TC20,36760,32,32000,4760
14362108,44944,TC20,37060,37,37000,60
14353830,44942,TC20,32000,32,32000,0
14393189,44957,TC20,30780,30,30000,780
14418194,44966,TC20,30740,31,31000,-260
14348060,44942,TC20,30740,30,30000,740
14491748,44994,TC20,36760,30,30000,6760
14351595,44939,TC20,35740,35,35000,740
14389192,44953,TC20,36740,33,33000,3740
14393190,44957,TC20,30840,30,30000,840
14502140,44999,TC20,32920,32,32000,920
14461007,44984,TC20,30940,30,30000,940
14389074,44953,TC20,30740,31,31000,-260
14414160,44966,TC20,36680,31,31000,5680
14358151,44943,TC20,30740,31,31000,-260
14469600,44986,TC20,33060,36,36000,-2940
14510268,44999,TC20,5000,5,5000,0
14357394,44946,TC20,28000,30,30000,-2000
14454053,44979,TC26,28000,28,28000,0
14445819,44974,TC20,5000,5,5000,0
14403261,44973,TC20,25000,25,25000,0
14390957,44956,TC20,8725,4,4000,4725
14418112,44967,TC20,26500,26,26000,500
14391816,44956,TC20,28000,28,28000,0
14528688,45007,TC20,28000,28,28000,0
14528680,45006,TC20,27000,27,27000,0
14528680,45006,TC20,27000,,27000,0
14418570,44965,TC20,27000,27,27000,0
14445788,44974,TC20,5000,,5000,0
14445788,44974,TC20,5000,,5000,0
14396719,44957,TC20,8540,,8540,0
14396719,44957,TC20,8540,4,4000,4540
14396719,44957,TC20,8540,,8540,0
14525483,45005,TC20,5000,4,4000,1000
14525483,45005,TC20,5000,,5000,0
14454097,44978,TC20,9000,4,4000,5000
14440220,44972,TC20,5000,4,4000,1000
14526260,45009,TC20,36410,31,31000,5410
14520396,45005,TC20,33100,32,32000,1100
14438099,44974,TC20,33040,33,33000,40
14364786,44946,TC20,36470,31,31000,5470
14327454,44930,TC20,32880,30,30000,2880
14326330,44929,TC20,35430,35,35000,430
14364795,44949,TC20,36550,31,31000,5550
14510047,45001,TC20,33080,35,35000,-1920
14380400,44950,TC20,5000,5,5000,0
14398834,44957,TC20,5000,5,5000,0
14436331,44972,TC20,9000,9,9000,0
14338043,44930,TC23,9000,4,4000,5000
14397658,44958,TC20,32690,33,33000,-310
14368357,44945,TC23,32000,32,32000,0
14331061,44936,TC23,31000,30,30000,1000
14404527,44959,TC23,36000,30,30000,6000
14408134,44970,TC23,32000,32,32000,0
14399639,44967,TC23,32000,32,32000,0
14432611,44970,TC20,5000,5,5000,0
14336952,44936,TC23,30020,30,30000,20
14365308,44960,TC23,30000,30,30000,0
14383615,44966,TC23,32000,4,4000,28000
14414380,44974,TC23,30000,30,30000,0
14479836,44988,TC20,32240,34,34000,-1760
14492749,44994,CON30,29780,30,30000,-220
14327880,44931,CON30,30440,30,30000,440
14353281,44944,CON30,30640,32,32000,-1360
14339463,44937,CON30,31340,32,32000,-660
14462537,44988,CON30,28820,31,31000,-2180
14524247,45007,CON30,30200,31,31000,-800
14516265,45005,CON30,31500,32,32000,-500
14327877,44929,CON30,30580,31,31000,-420
14327877,44929,CON30,30580,,30580,0
14526036,45008,TC20,5000,4,4000,1000
14326591,44928,TC20,5000,5,5000,0
14329740,44929,TC20,38000,32,32000,6000
14381399,44952,TC20,5000,4,4000,1000
14414157,44963,TC20,26000,21,21000,5000
14477072,44991,TC20,27720,27,27000,720
14487373,44994,TC20,23720,24,24000,-280
14330946,44931,TC20,25400,23,23000,2400
14347890,44939,TC20,23720,23,23000,720
14532324,45009,TC20,29720,29,29000,720
14375556,44952,TC20,30720,30,30000,720
14362937,44943,TC20,27000,21,21000,6000
14433022,44971,TC20,27870,28,28000,-130
14422157,44966,TC20,24000,24,24000,0
14508488,45001,TC20,27770,27,27000,770
14498372,44998,TC20,25300,25,25000,300
14458118,44981,TC20,23800,25,25000,-1200
14379735,44949,TC20,33000,27,27000,6000
14320115,44930,TC20,30000,30,30000,0
14337421,44943,TC20,29100,29,29000,100
14373299,44946,TC20,29000,27,27000,2000
14401624,44967,TC20,27000,27,27000,0
14330959,44929,TC26,5000,5,5000,0
14469964,44985,TC20,23750,24,24000,-250
14477836,44988,TC20,5000,3,3000,2000
14506844,44999,TC20,25150,25,25000,150
14514098,45002,TC20,22000,21,21000,1000
14491046,44999,TC20,32710,32,32000,710
14419793,44967,TC20,29830,29,29000,830
14345082,44937,CON20,4000,4,4000,0
14433718,44971,TC20,5000,4,4000,1000
14426116,44967,TC20,24500,25,25000,-500
14379723,44950,TC20,35000,23,23000,12000
14417297,44966,TC20,27650,27,27000,650
14336492,44935,TC20,33000,28,28000,5000
14494646,44994,TC20,33000,29,29000,4000
14482447,44991,TC20,31000,30,30000,1000
14486849,44992,TC20,5000,5,5000,0
14530166,45007,SWAP20,23000,24,24000,-1000
14526861,45006,TC20,23650,24,24000,-350
14373033,44946,SWAP20,26650,25,25000,1650
14426419,44967,TC20,34000,28,28000,6000
14426419,44967,TC20,34000,,34000,0
14426419,44967,TC20,34000,,34000,0
14413198,44963,TC20,34000,28,28000,6000
14396619,44958,TC20,34000,27,27000,7000
14374997,44946,TC20,28650,24,24000,4650
14526867,45006,TC20,23955,22,22000,1955
14381013,44951,TC20,29000,29,29000,0
14381013,44951,TC20,29000,,29000,0
14520189,45002,TC20,5000,,5000,0
14520189,45002,TC20,5000,4,4000,1000
14388867,44956,TC20,27800,26,26000,1800
14510650,45001,TC20,30000,30,30000,0
14495005,44994,TC20,29000,29,29000,0
14425848,44967,TC20,34000,29,29000,5000
14485390,44991,TC20,27520,24,24000,3520
14481769,44991,TC20,26100,26,26000,100
14367390,44949,TC20,34000,30,30000,4000
14327869,44928,TC20,34000,30,30000,4000
14463594,44981,TC20,23700,24,24000,-300
14482422,44991,TC20,5000,4,4000,1000
14473374,44986,TC20,5000,5,5000,0
14461569,44984,TC20,5000,5,5000,0
14421485,44970,TC23,32000,32,32000,0
14344398,44936,TC20,32000,31,31000,1000
14521271,45006,TC20,28940,28,28000,940
14491745,44995,TC23,36000,36,36000,0
14399637,44967,TC23,32000,32,32000,0
14365468,44945,TC23,30000,30,30000,0
14494890,45005,TC23,32000,30,30000,2000
14339182,44937,TC20,28820,28,28000,820
14357633,44939,TC20,25000,29,29000,-4000
14330738,44936,TC20,28820,28,28000,820
14339575,44936,TC20,31800,31,31000,800
14339575,44936,TC20,31800,,31800,0
14388404,44953,TC26,32000,32,32000,0
14326204,44928,TC26,28000,29,29000,-1000
14387116,44953,TC20,30080,31,31000,-920
14387168,44956,TC26,31000,31,31000,0
14433228,44972,TC26,31000,31,31000,0
14418161,44967,TC26,35630,35,35000,630
14463985,44985,TC20,36000,31,31000,5000
14337406,44942,TC23,32000,32,32000,0
14469969,44991,TC23,30000,30,30000,0
14528306,45009,TC26,31000,31,31000,0
14365180,44953,TC20,30590,31,31000,-410
14488574,44995,TC23,29000,29,29000,0
14366723,44950,TC20,31020,32,32000,-980
14418093,44966,TC20,30020,30,30000,20
14494888,45005,TC25,32000,32,32000,0
14516423,45002,TC23,33980,29,29000,4980
14365101,44953,TC23,30000,30,30000,0
14418094,44966,TC20,30020,30,30000,20
14477033,44988,TC23,33960,30,30000,3960
14424828,44970,TC23,32120,32,32000,120
14387181,44952,TC20,30020,31,31000,-980
14346209,44936,TC20,9000,4,4000,5000
14383614,44966,TC23,32000,32,32000,0
14348134,44936,TC23,9000,4,4000,5000
14445943,44981,TC25,30000,30,30000,0
14348911,44944,TC20,5000,5,5000,0
14364218,44944,TC26,30980,30,30000,980
14472501,44987,TC20,27920,30,30000,-2080
14460887,44981,TC20,5000,5,5000,0
14397307,44958,TC23,30000,30,30000,0
14375536,44946,TC23,25000,25,25000,0
14401994,44960,TC20,32690,30,30000,2690
14354940,44942,TC20,35000,30,30000,5000
14481535,44991,TC20,29690,30,30000,-310
14392925,44957,TC26,28000,28,28000,0
14437678,44972,TC20,37000,32,32000,5000
14436369,44973,TC20,25690,25,25000,690
14496465,44995,TC20,32000,,32000,0
14496465,44995,TC20,32000,32,32000,0
14397351,44958,TC26,30000,30,30000,0
14397351,44958,TC26,30000,,30000,0
14355292,44943,TC20,31390,30,30000,1390
14399321,44958,TC26,25000,25,25000,0
14347862,44936,TC20,5000,5,5000,0
14502142,44998,TC20,27690,28,28000,-310
14423215,44970,TC26,21000,21,21000,0
14365103,44944,TC26,33000,33,33000,0
14330458,44930,TC26,28000,28,28000,0
14390956,44956,TC20,34600,29,29000,5600
14357993,44943,TC25,29260,30,30000,-740
14481450,44988,TC20,9640,10,10000,-360
14444102,44977,TC20,31680,32,32000,-320
14396078,44957,TC20,38000,32,32000,6000
14362706,44951,TC20,31420,31,31000,420
14452587,44978,TC20,5000,5,5000,0
14481478,44988,TC20,28080,28,28000,80
14351867,44946,TC20,30600,30,30000,600
14508374,44998,TC26,35000,,35000,0
14508374,44998,TC26,35000,33,33000,2000
14382883,44957,TC20,31600,31,31000,600
14455818,44979,TC20,5000,,5000,0
14455818,44979,TC20,5000,5,5000,0
14481536,44991,TC20,27600,27,27000,600
14328647,44929,TC20,32600,32,32000,600
14531640,45009,TC20,27600,28,28000,-400
14490304,44993,TC20,27600,30,30000,-2400
14507044,44999,TC20,32600,33,33000,-400
14364772,44943,TC26,28000,28,28000,0
14421482,44967,TC26,32000,,32000,0
14392440,44956,TC20,32600,31,31000,1600
14397801,44957,TC20,5000,5,5000,0
14519294,45002,TC20,28239,,28239,0
14519294,45002,TC20,28239,28,28000,239
14375535,44950,TC26,28000,28,28000,0
14469868,44986,TC20,27600,27,27000,600
14366483,44946,TC26,28000,28,28000,0
14397659,44958,TC20,14600,15,15000,-400
14356992,44943,TC20,30820,30,30000,820
14458131,44981,TC20,5000,5,5000,0
14451748,44977,TC26,41360,31,31000,10360
14365181,44950,TC20,31600,31,31000,600
14416923,44966,TC20,32600,32,32000,600
14414768,44964,TC26,26860,27,27000,-140
14502730,45000,TC26,17000,17,17000,0
14536895,45009,TC20,27600,28,28000,-400
14328572,44930,TC26,28000,28,28000,0
14328572,44930,TC26,28000,,28000,0
14375708,44951,TC26,30000,30,30000,0
14502657,44998,TC26,32000,31,31000,1000
14432617,44971,TC20,28860,28,28000,860
14432617,44971,TC20,28860,28,28000,860
14375101,44950,TC23,30960,24,24000,6960
14404122,44960,TRA,30960,27,27000,3960
14329798,44928,TC20,32000,27,27000,5000
14329798,44928,TC20,32000,29,29000,3000
14374713,44949,TC20,31960,27,27000,4960
14502764,45001,TC26,24511,25,25000,-489
14439216,44973,TC26,34600,30,30000,4600
14457643,44981,TC26,31000,31,31000,0
14390565,44957,TC20,30600,31,31000,-400
14441262,44974,TC26,36760,30,30000,6760
14509990,44999,TC20,27000,29,29000,-2000
14509990,44999,TC20,27000,,27000,0
14509990,44999,TC20,27000,29,29000,-2000
14502128,44998,TC26,31000,31,31000,0
14463999,44985,TC20,5000,5,5000,0
14392372,44953,TC20,5000,5,5000,0
14367959,44945,TC23,32000,32,32000,0
14325972,44928,TC20,31960,32,32000,-40
14509202,44999,TC20,5000,5,5000,0
14509202,44999,TC20,5000,,5000,0
14509202,44999,TC20,5000,4,4000,1000
14508407,44999,TC20,33000,31,31000,2000
14498072,44995,TC20,5000,,5000,0
14498072,44995,TC20,5000,5,5000,0
14340233,44937,TC26,33000,33,33000,0
14454974,44979,TC20,31580,31,31000,580
14389914,44953,TC20,31600,32,32000,-400
14386329,44952,TC20,5000,4,4000,1000
14388399,44956,TC20,30380,30,30000,380
14336602,44931,TC26,32000,30,30000,2000
14407482,44960,TC20,33060,32,32000,1060
14331716,44931,TC26,28000,28,28000,0
14434592,44973,TC26,28000,28,28000,0
14478598,44987,TC20,13600,13,13000,600
14535233,45009,TC20,5000,5,5000,0
14381081,44953,TC20,5000,5,5000,0
14351339,44938,TC26,32000,32,32000,0
14341636,44939,TC26,33960,33,33000,960
14533436,45008,TC20,18800,17,17000,1800
14508411,44999,TC20,32000,31,31000,1000
14366402,44945,TC26,36560,32,32000,4560
14408907,44966,TC20,29960,31,31000,-1040
14440982,44974,TC23,32000,32,32000,0
14339512,44937,TC20,31300,32,32000,-700
14460638,44981,TC20,31040,32,32000,-960
14508396,44999,TC20,34000,33,33000,1000
14508396,44999,TC20,34000,,34000,0
14508396,44999,TC20,34000,32,32000,2000
14408688,44960,TC26,32000,30,30000,2000
14533445,45008,TC20,35000,21,21000,14000
14345098,44936,TC26,32000,32,32000,0
14443654,44978,TC20,5000,5,5000,0
14361611,44950,TC20,28420,29,29000,-580
14453989,44979,TC20,27300,27,27000,300
14455819,44979,TC20,5000,5,5000,0
14446453,44991,TC26,34360,30,30000,4360
14470477,44986,TC26,21000,21,21000,0
14520953,45005,TC26,32000,32,32000,0
14365162,44950,TC20,30320,30,30000,320
14443577,44973,TC20,30000,,30000,0
14443577,44973,TC20,30000,,30000,0
14443577,44973,TC20,30000,32,32000,-2000
14524410,45005,TC26,27000,27,27000,0
14414184,44964,TC20,33000,27,27000,6000
14422472,44967,CON20,6000,6,6000,0
14345165,44935,CON20,4000,3,3000,1000
14442740,44973,CON40,19000,19,19000,0
14367378,44949,TC20,33000,29,29000,4000
14327854,44928,TC20,33000,29,29000,4000
14459963,44980,TC20,23750,23,23000,750
14374610,44946,TC20,28750,,28750,0
14374610,44946,TC20,28750,24,24000,4750
14418548,44965,TC20,23750,23,23000,750
14373037,44946,SWAP20,26750,24,24000,2750
14331145,44929,TC20,31750,25,25000,6750
14396527,44958,TC20,34000,,34000,0
14396527,44958,TC20,34000,28,28000,6000
14418555,44965,TC20,23750,23,23000,750
14408144,44963,TC20,28000,28,28000,0
14526869,45006,TC20,23750,24,24000,-250
14418560,44965,TC20,23750,23,23000,750
14509986,45000,TC20,31000,,31000,0
14509986,45000,TC20,31000,30,30000,1000
14526872,45006,TC20,23750,,23750,0
14526872,45006,TC20,23750,24,24000,-250
14490431,44992,TC20,31000,31,31000,0
14490431,44992,TC20,31000,,31000,0
14373038,44946,SWAP20,26750,24,24000,2750
14482915,44988,TC20,5000,3,3000,2000
14475066,44988,TC20,35000,31,31000,4000
14408142,44963,TC20,28000,28,28000,0
14327867,44928,TC20,34000,29,29000,5000
14367387,44949,TC20,33000,28,28000,5000
14357664,44943,TC20,33000,28,28000,5000
14468610,44985,TC20,32000,30,30000,2000
14327745,44928,TC20,33000,29,29000,4000
14426417,44967,TC20,34000,28,28000,6000
14502363,44998,TC20,28000,26,26000,2000
14505921,44998,TC20,5000,4,4000,1000
14502370,44998,TC20,28000,28,28000,0
14502816,45002,TC20,28000,28,28000,0
14505926,44998,TC20,5000,4,4000,1000
14451309,44978,TC20,28000,28,28000,0
14510155,44999,TC20,5000,4,4000,1000
14375149,44949,TC20,28000,28,28000,0
14433069,44974,TC20,28000,28,28000,0
14506821,44998,TC20,31000,,31000,0
14506821,44998,TC20,31000,31,31000,0
14494596,44994,TC20,32000,30,30000,2000
14475064,44988,TC20,36000,31,31000,5000
14494546,44994,TC20,33000,,33000,0
14494546,44994,TC20,33000,31,31000,2000
14482448,44991,TC20,31000,32,32000,-1000
14524418,45006,TC20,28000,28,28000,0
14367374,44950,TC20,35000,30,30000,5000
14509185,44999,TC20,22050,24,24000,-1950
14459964,44980,TC20,24150,24,24000,150
14481770,44991,TC20,26150,25,25000,1150
14418562,44965,TC20,24150,23,23000,1150
14341114,44936,TC20,21150,16,16000,5150
14423311,44971,TC20,5000,5,5000,0
14423310,44971,TC20,5000,5,5000,0
14513815,45001,TC20,5000,4,4000,1000
14502193,44998,TC20,5000,5,5000,0
14341547,44936,TC20,5000,5,5000,0
14350317,44942,TC20,5000,5,5000,0
14345395,44938,TC20,5000,5,5000,0
14341546,44936,TC20,5000,5,5000,0
14513816,45001,TC20,5000,4,4000,1000
14402402,44959,TC20,5000,5,5000,0
14330930,44929,TC20,5000,5,5000,0
14345398,44938,TC20,5000,5,5000,0
14535234,45008,TC20,5000,3,3000,2000
14479840,44991,TC20,5000,5,5000,0
14392893,44957,TC20,5000,5,5000,0
14392891,44957,TC20,5000,5,5000,0
14386014,44958,TC20,5000,2,2000,3000
14452629,44979,TC20,5000,5,5000,0
14473036,44986,TC20,5000,5,5000,0
14496789,44994,TC20,5000,5,5000,0
14350316,44942,TC20,5000,5,5000,0
14361612,44945,TC20,5000,5,5000,0
14535232,45008,TC20,5000,4,4000,1000
14330929,44930,TC20,5000,3,3000,2000
14423309,44971,TC20,5000,4,4000,1000
14358110,44944,TC20,5000,5,5000,0
14335506,44991,CON45,4500,4,4000,500
14424807,44978,CON45,4500,5,5000,-500
14365731,44950,CON45,4500,6,6000,-1500
14437721,44973,CON45,4500,6,6000,-1500
14436584,44977,CON45,4500,4,4000,500
14338927,44939,CON45,4500,4,4000,500
14463923,44987,CON45,4500,4,4000,500
14471617,44995,CON45,4500,5,5000,-500
14490392,44995,CON45,4500,5,5000,-500
14401977,44963,CON45,4500,4,4000,500
14334699,44981,CON45,4500,4,4000,500
14476915,44991,CON45,4500,5,5000,-500
14429454,45009,CON45,4500,,4500,0
14442445,44985,CON45,4500,,4500,0
14508549,44999,CON45,13000,13,13000,0
14471616,44988,CON45,4500,4,4000,500
14495224,44998,CON45,4500,4,4000,500
14490390,44995,CON45,4500,6,6000,-1500
14503147,45000,CON45,4500,6,6000,-1500
14436242,44976,CON45,4500,4,4000,500
14452551,44981,CON45,4500,5,5000,-500
14318167,44963,CON45,4500,6,6000,-1500
14428350,44998,CON45,4500,4,4000,500
14458853,44985,CON45,4500,6,6000,-1500
14405300,44964,CON45,4500,6,6000,-1500
14451475,44980,CON45,4500,4,4000,500
14455650,44986,CON45,4500,6,6000,-1500
14408326,44964,CON45,4500,6,6000,-1500
14408326,44964,CON45,4500,,4500,0
14317547,44956,CON45,4500,4,4000,500
14354729,44942,CON45,4500,6,6000,-1500
14528256,45009,CON45,4500,6,6000,-1500
14409037,44960,CON45,4500,4,4000,500
14409037,44960,CON45,4500,,4500,0
14457451,44982,CON45,4500,4,4000,500
14458818,44984,CON45,4500,7,7000,-2500
14475684,45005,CON45,4500,4,4000,500
14396890,44960,CON45,4500,7,7000,-2500
14396890,44960,CON45,4500,,4500,0
14371633,44950,CON45,4500,6,6000,-1500
14346214,44936,CON45,4500,6,6000,-1500
14446323,44980,CON45,4500,4,4000,500
14333591,44977,CON45,4500,6,6000,-1500
14337581,44935,CON45,4500,6,6000,-1500
14483214,44992,CON45,4500,5,5000,-500
14339440,44942,CON45,4500,5,5000,-500
14318166,44963,CON45,4500,6,6000,-1500
14497287,45001,CON45,4500,4,4000,500
14340248,44936,CON45,4500,6,6000,-1500
14316911,44949,CON45,4500,4,4000,500
14375529,44951,CON45,4500,4,4000,500
14413185,44963,CON45,4500,7,7000,-2500
14329984,44932,CON45,4500,4,4000,500
14314794,44928,CON45,4500,4,4000,500
14358133,44950,CON45,4500,6,6000,-1500
14452389,44981,CON45,4500,4,4000,500
14442316,44978,CON45,13000,13,13000,0
14418572,44967,CON45,4500,5,5000,-500
14481829,44991,CON45,4500,4,4000,500
14382863,44959,CON45,4500,4,4000,500
14498951,45000,CON45,4500,4,4000,500
14448053,44980,CON45,4500,4,4000,500
14524616,45007,CON45,4500,4,4000,500
14326053,44928,CON45,4500,4,4000,500
14413183,44965,CON45,4500,4,4000,500
14498952,45002,CON45,4500,5,5000,-500
14292073,44928,CON45,4500,4,4000,500
14428936,45002,CON45,4500,5,5000,-500
14510113,45005,CON45,4500,4,4000,500
14510012,45002,CON45,4500,6,6000,-1500
14483366,44993,CON45,4500,6,6000,-1500
14502717,45001,CON45,4500,4,4000,500
14330551,44931,CON45,4500,4,4000,500
14332337,44938,CON45,4500,4,4000,500
14483262,44993,CON45,4500,7,7000,-2500
14507956,45001,CON45,4500,4,4000,500
14521021,45007,CON45,4500,4,4000,500
14521021,45007,CON45,4500,,4500,0
14404864,44964,CON45,4500,4,4000,500
14409053,44964,CON45,4500,4,4000,500
14463654,44992,CON45,4500,4,4000,500
14460935,44984,CON45,4500,4,4000,500
14401978,44963,CON45,4500,7,7000,-2500
14327889,44929,CON45,4500,4,4000,500
14396600,44960,CON45,4500,6,6000,-1500
14425212,44972,CON45,4500,6,6000,-1500
14510126,45002,CON45,4500,6,6000,-1500
14436576,44971,CON45,4500,5,5000,-500
14392130,44956,CON45,4500,4,4000,500
14371570,44950,CON45,4500,4,4000,500
14406044,44964,CON45,4500,4,4000,500
14332340,44938,CON45,4500,5,5000,-500
14335505,44991,CON45,4500,4,4000,500
14406908,44972,CON45,4500,5,5000,-500
14452553,44981,CON45,4500,4,4000,500
14441221,44977,CON45,4500,5,5000,-500
14490395,44995,CON45,4500,5,5000,-500
14419474,44971,CON45,4500,4,4000,500
14386170,44956,CON45,4500,4,4000,500
14457468,44983,CON45,4500,4,4000,500
14436078,44976,CON45,4500,4,4000,500
14478651,44991,CON45,4500,4,4000,500
14362734,44943,CON45,13000,13,13000,0
14375988,44951,CON45,4500,4,4000,500
14398966,44964,CON45,4500,4,4000,500
14316914,44951,CON45,4500,4,4000,500
14463932,44986,CON45,4500,4,4000,500
14507957,45002,CON45,4500,5,5000,-500
14507957,45002,CON45,4500,,4500,0
14392131,44956,CON45,4500,4,4000,500
14518087,45006,CON45,4500,10,10000,-5500
14482393,44993,CON45,4500,4,4000,500
14382856,44953,CON45,4500,5,5000,-500
14330994,44932,CON45,4500,4,4000,500
14462523,44985,CON45,13000,13,13000,0
14460936,44984,CON45,4500,4,4000,500
14333456,44974,CON45,4500,4,4000,500
14340250,44943,CON45,4500,4,4000,500
14477065,44993,CON45,4500,4,4000,500
14497286,45000,CON45,4500,4,4000,500
14392853,44960,CON45,4500,4,4000,500
14425213,44970,CON45,4500,6,6000,-1500
14510285,45002,CON45,4500,5,5000,-500
14490391,44995,CON45,4500,4,4000,500
14528249,45008,CON45,4500,4,4000,500
14462046,44983,CON45,4500,4,4000,500
14350092,44941,CON45,4500,5,5000,-500
14469837,44987,CON45,4500,5,5000,-500
14438117,44977,CON45,4500,7,7000,-2500
14380213,44950,CON45,13000,13,13000,0
14510651,45002,CON45,4500,4,4000,500
14330030,44932,CON45,4500,4,4000,500
14390607,44957,CON45,4500,5,5000,-500
14413184,44965,CON45,4500,4,4000,500
14520914,45006,CON45,4500,6,6000,-1500
14382864,44957,CON45,4500,4,4000,500
14362878,44946,CON45,4500,7,7000,-2500
14366484,44951,CON45,4500,4,4000,500
14457506,44985,CON45,4500,4,4000,500
14497070,44999,CON45,4500,4,4000,500
14251643,44939,CON45,4500,5,5000,-500
14317435,44953,CON45,4500,5,5000,-500
14333458,44976,CON45,4500,4,4000,500
14358171,44944,CON45,4500,6,6000,-1500
14335419,44988,CON45,4500,4,4000,500
14496912,44997,CON45,4500,6,6000,-1500
14477064,44992,CON45,13000,13,13000,0
14416414,44967,CON45,4500,4,4000,500
14389177,44958,CON45,4500,4,4000,500
14326616,44928,CON45,4500,6,6000,-1500
14404027,44963,CON45,4500,7,7000,-2500
14367513,44949,CON45,4500,7,7000,-2500
14348339,44938,CON45,4500,4,4000,500
14497068,44999,CON45,4500,4,4000,500
14387099,44957,CON45,13000,13,13000,0
14335406,44988,CON45,4500,4,4000,500
14318174,44964,CON45,13000,11,11000,2000
14501981,44999,CON45,4500,4,4000,500
14510322,45002,CON45,4500,5,5000,-500
14502253,45001,CON45,4500,5,5000,-500
14414781,44966,CON45,4500,4,4000,500
14414781,44966,CON45,4500,,4500,0
14424398,44971,CON45,4500,5,5000,-500
14322344,44929,CON45,13000,13,13000,0
14452554,44981,CON45,4500,4,4000,500
14491933,44992,CON45,4500,4,4000,500
14409035,44960,CON45,4500,6,6000,-1500
14470450,44988,CON45,4500,30,30000,-25500
14345205,44937,CON45,4500,4,4000,500
14407782,44964,CON40,28000,24,24000,4000
14345308,44949,CON40,18800,15,15000,3800
14333057,44935,TC20,30000,30,30000,0
14494062,45005,TC20,5000,5,5000,0
14349165,44942,TC20,30000,30,30000,0
14375128,44953,TC20,31000,31,31000,0
14426821,44980,TC20,5000,5,5000,0
14426822,44977,TC20,5000,5,5000,0
14482929,44999,TC20,5000,5,5000,0
14477884,44994,TC20,30000,30,30000,0
14349163,44939,TC20,30000,30,30000,0
14381397,44949,TC20,31000,31,31000,0
14421701,44966,TC20,5000,4,4000,1000
14458716,44984,TC20,5000,5,5000,0
14458719,44984,TC20,5000,5,5000,0
14494058,45005,TC20,5000,5,5000,0
14482927,44998,TC20,5000,5,5000,0
14426823,44977,TC20,5000,5,5000,0
14482928,45001,TC20,5000,5,5000,0
14458717,44984,TC20,5000,5,5000,0
14375127,44964,TC20,31000,31,31000,0
14423254,44971,TC20,31000,30,30000,1000
14482926,45001,TC20,5000,5,5000,0
14511393,44999,TC20,5000,4,4000,1000
14386602,44958,TC20,5000,3,3000,2000
14386602,44958,TC20,5000,,5000,0
14386602,44958,TC20,5000,,5000,0
14386602,44958,TC20,5000,,5000,0
14458715,44985,TC20,5000,5,5000,0
14386601,44957,TC20,5000,5,5000,0
14339371,44942,TC20,30000,31,31000,-1000
14399360,44957,TC20,5000,5,5000,0
14324861,44928,CON40,19000,25,25000,-6000
14324862,44928,CON40,25000,20,20000,5000
14509844,45000,CON40,24000,,24000,0
14509844,45000,CON40,24000,24,24000,0
14488004,44993,CON40,24000,,24000,0
14488004,44993,CON40,24000,,24000,0
14510063,45001,CON40,23000,24,24000,-1000
14408038,44965,CON40,27000,24,24000,3000
14408030,44964,CON40,29000,25,25000,4000
14477762,44994,CON40,24000,24,24000,0
14477762,44994,CON40,24000,24,24000,0
14327892,44929,CON40,19000,14,14000,5000
14327895,44929,CON40,17000,13,13000,4000
14408041,44964,CON40,27000,24,24000,3000
14327896,44929,CON40,17000,13,13000,4000
14327896,44929,CON40,17000,12,12000,5000
14477760,44994,CON40,25000,25,25000,0
14414098,44965,TC20,30630,30,30000,630
14402675,44960,TC20,31450,32,32000,-550
14405423,44963,TC20,33000,33,33000,0
14390569,44956,TC20,30680,31,31000,-320
14457647,44981,TC20,36740,35,35000,1740
14390374,44956,TC20,33000,31,31000,2000
14525692,45007,TC20,36820,32,32000,4820
14402241,44959,TC20,33020,30,30000,3020
14354735,44943,TC20,32690,32,32000,690
14524124,45006,TC20,33000,33,33000,0
14371120,44958,TC20,29910,30,30000,-90
14347640,44944,TC20,29910,30,30000,-90
14320063,44928,TC20,31000,31,31000,0
14397458,44965,TC20,31000,30,30000,1000
14493816,45002,TC20,31000,32,32000,-1000
14330396,44935,TC20,27000,30,30000,-3000
14434402,44979,TC20,29710,30,30000,-290
14330284,44936,TC20,29710,30,30000,-290
14405173,44967,TC20,29910,29,29000,910
14404846,44967,TC20,31000,31,31000,0
14330397,44935,TC20,31000,31,31000,0
14330397,44935,TC20,31000,,31000,0
14434410,44974,TC20,31000,30,30000,1000
14485391,44991,TC20,23700,23,23000,700
14493547,44993,TRA,31000,,31000,0
14493547,44993,TRA,31000,27,27000,4000
14434182,44970,TRA,39000,31,31000,8000
14382970,44950,PTRA,39000,34,34000,5000
14530205,45007,TRA,32000,24,24000,8000
14427273,44971,TC20,5000,5,5000,0
14427274,44971,TC20,5000,4,4000,1000
14427276,44972,TC20,5000,4,4000,1000
14427278,44972,TC20,5000,4,4000,1000
14427279,44972,TC20,5000,4,4000,1000
14427282,44972,TC20,5000,5,5000,0
14427281,44972,TC20,5000,4,4000,1000
14379747,44951,TC20,5000,5,5000,0
14513576,45000,TC20,5000,5,5000,0
14365205,44944,TC20,5000,5,5000,0
14398945,44965,TC20,5000,4,4000,1000
14345024,44937,TC20,5000,4,4000,1000
14530755,45007,TC20,5000,5,5000,0
14493136,44993,TC20,5000,4,4000,1000
14461002,44986,TC20,5000,6,6000,-1000
14426262,44967,TC20,5000,5,5000,0
14480000,44988,TC20,5000,5,5000,0
14345023,44936,TC20,5000,3,3000,2000
14385930,44951,TC20,5000,5,5000,0
14496915,44995,TC20,5000,5,5000,0
14451548,44978,TC20,5000,4,4000,1000
14460860,44981,TC20,5000,5,5000,0
14517232,45006,TC20,5000,4,4000,1000
14406063,44960,TC20,5000,4,4000,1000
14422386,44970,CON30,4000,3,3000,1000
14357918,44939,CON20,37000,32,32000,5000
14414226,44964,TRA,39000,,39000,0
14414226,44964,TRA,39000,33,33000,6000
14414264,44963,TRA,39000,,39000,0
14414264,44963,TRA,39000,30,30000,9000
14380241,44949,TRA,42000,,42000,0
14380241,44949,TRA,42000,34,34000,8000
14416691,44965,TRA,42000,31,31000,11000
14416691,44965,TRA,42000,31,31000,11000
14376307,44951,CON20,5400,6,6000,-600
14358156,44943,CON20,5880,6,6000,-120
14341534,44936,CON20,5880,6,6000,-120
14465341,44992,CON20,5970,6,6000,-30
14490396,44995,TC20,25000,25,25000,0
14355743,44946,TC20,30000,,30000,0
14355743,44946,TC20,30000,30,30000,0
14456976,44984,TC20,30000,30,30000,0
14398920,44960,TC20,25000,,25000,0
14398920,44960,TC20,25000,,25000,0
14398920,44960,TC20,25000,,25000,0
14356942,44950,TC20,29000,29,29000,0
14356942,44950,TC20,29000,,29000,0
14420195,44971,TC20,30000,30,30000,0
14509713,45007,TC20,29000,30,30000,-1000
14508551,45005,TC20,29000,29,29000,0
14525036,45007,TC20,25000,25,25000,0
14442731,44986,TC20,23500,25,25000,-1500
14417487,44966,TC20,33000,31,31000,2000
14404163,44966,TC20,29000,30,30000,-1000
14427145,44971,TC20,25000,28,28000,-3000
14478958,44993,TC20,25000,25,25000,0
14435716,44973,TC20,25000,26,26000,-1000
14406112,44974,TC20,29000,29,29000,0
14483456,44995,TC20,30000,30,30000,0
14452437,44988,TC20,29000,30,30000,-1000
14452437,44988,TC20,29000,,29000,0
14367953,44945,TC20,20000,5,5000,15000
14471648,44987,TC20,25000,25,25000,0
14367512,44949,TC20,33000,33,33000,0
14367952,44945,TC20,20000,5,5000,15000
14528244,45009,TC20,33000,33,33000,0
14380691,44956,TC20,29000,29,29000,0
14380691,44956,TC20,29000,,29000,0
14380691,44956,TC20,29000,,29000,0
14455094,44987,TC20,33000,33,33000,0
14487921,44999,TC20,29220,29,29000,220
14498460,44994,TC20,24000,27,27000,-3000
14470150,44991,TC20,30500,30,30000,500
14527766,45008,TC26,26000,26,26000,0
14436674,44977,TC26,31000,31,31000,0
14509922,45005,TC20,30500,30,30000,500
14385891,44959,TC20,30000,30,30000,0
14385891,44959,TC20,30000,,30000,0
14508564,45007,TC20,30000,30,30000,0
14469671,44991,TC20,31000,31,31000,0
14439677,44974,TC20,5000,5,5000,0
14433552,44971,TC20,5000,4,4000,1000
14375684,44956,TC20,31000,31,31000,0
14479162,44988,TC20,5000,5,5000,0
14487922,44998,TC20,31000,31,31000,0
14436942,44971,TC20,5000,4,4000,1000
14475071,44987,CON40,4000,4,4000,0
14415134,44970,CON40,29000,25,25000,4000
14345524,44937,CON40,4000,4,4000,0
14309407,44928,CON40,4000,4,4000,0
14309407,44928,CON40,4000,,4000,0
14385929,44952,CON40,4000,4,4000,0
14426421,44970,TC20,38000,34,34000,4000
14446994,44978,TC20,5000,5,5000,0
14345429,44939,TC20,5000,5,5000,0
14446971,44978,TC20,38000,33,33000,5000
14469946,44985,TC20,5000,4,4000,1000
14497764,44999,TC20,5000,4,4000,1000
14330808,44929,TC20,5000,3,3000,2000
14375593,44949,TC20,30000,30,30000,0
14476968,44988,TC20,29920,30,30000,-80
14502469,44999,TC20,23920,23,23000,920
14427576,44974,TC20,5000,4,4000,1000
14362936,44944,TC20,38000,32,32000,6000
14344404,44936,TC20,38000,33,33000,5000
14344404,44936,TC20,38000,,38000,0
14427565,44974,TC20,5000,5,5000,0
14517281,45002,TC20,5000,5,5000,0
14400053,44957,TRA,39000,31,31000,8000
14375161,44946,PTRA,39000,,39000,0
14375161,44946,PTRA,39000,,39000,0
14375161,44946,PTRA,39000,21,21000,18000
14375161,44946,PTRA,39000,,39000,0
14535399,45008,PTRA,32000,,32000,0
14347695,44937,TRA,38000,25,25000,13000
14474794,44992,CON20,8155,9,9000,-845
14473593,44987,TC25,5000,5,5000,0
14526718,45008,TC25,5000,5,5000,0
14524348,45005,CON40,10000,10,10000,0
14524348,45005,CON40,10000,,10000,0
14524350,45005,CON40,10000,10,10000,0
14524350,45005,CON40,10000,,10000,0
14472478,44986,TC20,5000,3,3000,2000
14372736,44953,TC20,26620,26,26000,620
14365090,44945,TC20,24570,25,25000,-430
14389130,44957,TC20,23570,23,23000,570
14389130,44957,TC20,23570,,23570,0
14433465,44973,TC20,23800,24,24000,-200
14392865,44956,TC23,28760,24,24000,4760
14414166,44965,TC20,28990,30,30000,-1010
14508491,45000,TC20,23880,23,23000,880
14345430,44942,TC20,23700,23,23000,700
14396375,44959,TC20,25000,24,24000,1000
14436119,44977,TC20,5000,5,5000,0
14381218,44956,TC20,5000,5,5000,0
14347734,44939,TC20,5000,5,5000,0
14406081,44963,TC20,5000,4,4000,1000
14356977,44943,TC20,5000,5,5000,0
14508471,45001,TC20,5000,5,5000,0
14452626,44981,TC20,5000,5,5000,0
14491242,45001,TC20,5000,3,3000,2000
14364781,44946,TC20,5000,5,5000,0
14469472,44987,TC20,23880,24,24000,-120
14473247,44988,TC20,36580,32,32000,4580
14444317,44977,TC20,36640,30,30000,6640
14493531,44995,TC20,36620,32,32000,4620
14520398,45006,TC20,36580,36,36000,580
14369473,44949,TC20,36700,30,30000,6700
14345821,44938,TC20,37660,32,32000,5660
14402240,44959,TC20,36600,31,31000,5600
14422703,44970,TC20,36580,31,31000,5580
14422702,44970,TC20,36940,31,31000,5940
14405225,44960,TC20,36900,30,30000,6900
14383261,44952,TC20,33020,36,36000,-2980
14322889,44928,TC20,37960,37,37000,960
14349422,44939,TC20,36940,,36940,0
14349422,44939,TC20,36940,36,36000,940
14516422,45005,TC20,33060,30,30000,3060
14488270,44993,TC20,36900,33,33000,3900
14457648,44981,TC20,36880,36,36000,880
14479165,44991,TC20,37760,37,37000,760
14330730,44931,TC20,37740,32,32000,5740
14402347,44959,TC20,37720,32,32000,5720
14353882,44942,TC20,37360,37,37000,360
14452584,44978,TC20,32340,32,32000,340
14528314,45008,TC20,32340,34,34000,-1660
14472450,44987,TC20,37260,32,32000,5260
14364785,44946,TC20,32260,32,32000,260
14311314,44930,TC20,37300,30,30000,7300
14311314,44930,TC20,37300,,37300,0
14319383,44928,TC20,37100,37,37000,100
14364792,44946,TC20,32340,32,32000,340
14472446,44988,TC20,37360,30,30000,7360
14491969,44994,TC20,37400,35,35000,2400
14337005,44935,TC20,37600,37,37000,600
14402275,44960,TC20,37420,37,37000,420
14405422,44963,TC20,33040,33,33000,40
14383262,44953,TC20,36210,37,37000,-790
14327453,44930,TC20,34000,32,32000,2000
14351596,44939,TC20,37190,37,37000,190
14487454,44993,TC20,36250,35,35000,1250
14460914,44984,TC20,33000,33,33000,0
14436438,44973,TC20,32980,30,30000,2980
14528415,45009,TC20,36190,,36190,0
14441264,44974,TC20,36170,36,36000,170
14478962,44991,TC20,36190,33,33000,3190
14513699,45002,TC20,33040,32,32000,1040
14364789,44945,TC20,36250,36,36000,250
14330749,44931,TC20,37250,33,33000,4250
14383260,44953,TC20,36190,31,31000,5190
14414389,44966,TC20,36190,36,36000,190
14347871,44939,TC20,38060,30,30000,8060
14454318,44981,TC20,38080,38,38000,80
14441030,44974,TC20,18740,18,18000,740
14478846,44991,TC20,18740,18,18000,740
14322891,44928,TC20,18740,18,18000,740
14415020,44965,TC20,28740,30,30000,-1260
14389075,44953,TC20,18740,18,18000,740
14525117,45007,TC20,18740,19,19000,-260
14371336,44950,TC20,24010,25,25000,-990
14508489,45000,TC20,24120,25,25000,-880
14433940,44972,TC20,21750,22,22000,-250
14441843,44973,TC20,26000,20,20000,6000
14338905,44931,TC20,32540,28,28000,4540
14454308,44980,TC20,30000,30,30000,0
14389033,44956,TC20,27860,28,28000,-140
14417198,44965,TC20,5000,4,4000,1000
14464103,44988,TC20,5000,5,5000,0
14474684,44987,TC20,5000,5,5000,0
14473209,44986,TC20,5000,5,5000,0
14436518,44974,TC20,23870,24,24000,-130
14415058,44966,TC20,23870,23,23000,870
14506850,44999,TC20,25600,26,26000,-400
14436485,44973,TC20,28100,30,30000,-1900
14510080,45002,TC20,28100,28,28000,100
14519362,45002,TRA,31000,17,17000,14000
14404598,44959,TRA,31000,,31000,0
14404598,44959,TRA,31000,29,29000,2000
14404598,44959,TRA,31000,,31000,0
14404598,44959,TRA,31000,,31000,0
14331240,44928,PTRA,42000,,42000,0
14331240,44928,PTRA,42000,35,35000,7000
14426455,44967,PTRA,39000,,39000,0
14426455,44967,PTRA,39000,,39000,0
14426455,44967,PTRA,39000,,39000,0
14426455,44967,PTRA,39000,32,32000,7000
14392696,44953,TRA,34000,27,27000,7000
14407556,44960,TRA,38000,,38000,0
14407556,44960,TRA,38000,,38000,0
14407556,44960,TRA,38000,,38000,0
14407556,44960,TRA,38000,32,32000,6000
14407556,44960,TRA,38000,,38000,0
14417501,44965,TC30,37500,31,31000,6500
14514919,45009,TC23,34280,34,34000,280
14468948,44987,TC30,35280,35,35000,280
14514950,45007,TC30,35180,30,30000,5180
14514951,45008,TC30,35200,30,30000,5200
14427144,44974,TC30,35560,30,30000,5560
14443049,44973,TC30,35000,30,30000,5000
14456953,44980,TC20,25000,24,24000,1000
14472364,44987,TC20,28260,30,30000,-1740
14330737,44936,TC20,29210,30,30000,-790
14390939,44953,TC26,32740,27,27000,5740
14454190,44985,TC23,15000,13,13000,2000
14490476,44993,TC20,30000,31,31000,-1000
14490476,44993,TC20,30000,,30000,0
14490476,44993,TC20,30000,,30000,0
14432972,44973,TC26,30500,30,30000,500
14339573,44936,TC20,25240,23,23000,2240
14339574,44936,TC20,24240,24,24000,240
14440399,44972,TC20,5000,5,5000,0
14442594,44977,TC26,12000,13,13000,-1000
14396696,44957,TC26,32740,28,28000,4740
14472146,44992,TC20,26240,26,26000,240
14427420,44972,TC20,5000,4,4000,1000
14491792,45001,TC20,26240,27,27000,-760
14446511,44985,TC20,26240,28,28000,-1760
14367547,44953,TC26,23500,24,24000,-500
14436807,44974,TC20,26130,28,28000,-1870
14417422,44967,TC20,24130,22,22000,2130
14444326,44978,TC26,29020,29,29000,20
14493832,44994,TC20,27150,28,28000,-850
14458580,44980,TC26,23000,23,23000,0
14327122,44928,TC20,31150,31,31000,150
14368761,44952,CON30,29920,31,31000,-1080
14368765,44950,CON30,30460,30,30000,460
14524248,45007,CON30,27260,27,27000,260
14516266,45006,CON30,31700,31,31000,700
14389128,44957,CON30,31120,31,31000,120
14371860,44950,CON30,29720,29,29000,720
14440358,44974,CON30,31000,31,31000,0
14368767,44949,CON30,30280,30,30000,280
14402401,44963,CON30,31300,31,31000,300
14339498,44943,CON45,31500,31,31000,500
14419827,44967,CON30,31180,31,31000,180
14533558,45009,TC20,5000,5,5000,0
14533563,45009,TC20,5000,5,5000,0
14533561,45009,TC20,5000,5,5000,0
14533562,45009,TC20,5000,,5000,0
14533562,45009,TC20,5000,5,5000,0
14533562,45009,TC20,5000,5,5000,0
14527891,45006,TC20,5000,,5000,0
14527891,45006,TC20,5000,5,5000,0
14444158,44974,TC20,5000,4,4000,1000
14444158,44974,TC20,5000,,5000,0
14444158,44974,TC20,5000,,5000,0
14510733,45006,CON30,8142,8,8000,142
14322797,44931,CON30,7700,7,7000,700
14332531,44936,CON30,7600,7,7000,600
14420201,44971,CON30,6391,7,7000,-609
14475508,44993,CON30,5147,7,7000,-1853
14475507,44993,CON30,7196,7,7000,196
14510644,45006,CON30,8400,9,9000,-600
14397646,44960,CON30,12000,12,12000,0
14444321,44978,CON30,6303,6,6000,303
14369434,44949,CON30,7500,4,4000,3500
14332429,44935,CON30,7700,7,7000,700
14332429,44935,CON30,7700,,7700,0
14510642,45005,CON30,6300,7,7000,-700
14419845,44970,CON30,5800,6,6000,-200
14389070,44956,CON30,7200,7,7000,200
14369431,44949,CON30,7700,4,4000,3700
14402054,44964,CON30,6028,7,7000,-972
14389071,44956,CON30,9800,9,9000,800
14475559,44991,CON30,7800,7,7000,800
14322796,44931,CON30,6500,6,6000,500
14322799,44931,CON30,8500,8,8000,500
14332430,44935,CON30,7600,7,7000,600
14349439,44942,CON30,5600,5,5000,600
14419840,44970,CON30,8100,9,9000,-900
14475553,44991,CON30,7500,7,7000,500
14475557,44991,CON30,6300,7,7000,-700
14463831,44984,CON30,6400,6,6000,400
14369433,44949,CON30,9100,4,4000,5100
14510643,45006,CON30,8300,9,9000,-700
14397649,44960,CON30,7700,7,7000,700
14444323,44978,CON30,5393,5,5000,393
14368789,44950,CON30,9457,7,7000,2457
14375829,44951,CON30,7000,6,6000,1000
14475552,44991,CON30,6600,7,7000,-400
14349448,44943,CON30,11832,12,12000,-168
14349446,44943,CON30,7200,9,9000,-1800
14401922,44966,CON30,9300,9,9000,300
14389168,44959,CON30,6000,9,9000,-3000
14401920,44963,CON30,5800,7,7000,-1200
14419843,44971,CON30,7800,8,8000,-200
14332530,44935,CON30,7300,7,7000,300
14494882,44999,CON30,6978,6,6000,978
14369432,44949,CON30,8200,4,4000,4200
14332506,44936,CON30,7511,,7511,0
14444161,44977,CON30,6700,7,7000,-300
14510731,45006,CON30,5737,7,7000,-1263
14349440,44942,CON30,7500,8,8000,-500
14463869,44986,CON30,7800,7,7000,800
14494883,44999,CON30,6719,6,6000,719
14332426,44935,CON30,5900,6,6000,-100
14332426,44935,CON30,5900,,5900,0
14419844,44971,CON30,7900,8,8000,-100
14420204,44971,CON30,5361,6,6000,-639
14420205,44972,CON30,6417,6,6000,417
14401923,44966,CON30,7700,7,7000,700
14444160,44977,CON30,6100,7,7000,-900
14463868,44987,CON30,7500,7,7000,500
14332428,44935,CON30,6000,,6000,0
14332428,44935,CON30,6000,6,6000,0
14349449,44943,CON30,6539,9,9000,-2461
14349445,44943,CON30,9000,9,9000,0
14401921,44963,CON30,8100,7,7000,1100
14368790,44950,CON30,7305,7,7000,305
14332532,44935,CON30,6600,7,7000,-400
14389068,44956,CON30,7700,8,8000,-300
14389197,44957,CON30,6041,6,6000,41
14332533,44936,CON30,8900,7,7000,1900
14349443,44942,CON30,6500,7,7000,-500
14389069,44956,CON30,6000,6,6000,0
14389196,44957,CON30,8123,8,8000,123
14349441,44942,CON30,6200,6,6000,200
14322798,44931,CON30,8100,8,8000,100
14510641,45005,CON30,6000,3,3000,3000
14475558,44991,CON30,8400,7,7000,1400
14475509,44993,CON30,6374,7,7000,-626
14389169,44959,CON30,7300,12,12000,-4700
14463829,44984,CON30,5800,6,6000,-200
14464043,44985,CON30,6173,7,7000,-827
14309719,44928,CON30,6041,6,6000,41
14366510,44943,TRA,32000,17,17000,15000
14380347,44949,TRA,39000,25,25000,14000
14469977,44984,TRA,25000,13,13000,12000
14425717,44967,TRA,25000,26,26000,-1000
14414670,44963,TC20,19000,11,11000,8000
14399359,44958,TC20,5000,5,5000,0
14479839,44991,TC20,5000,5,5000,0
14397147,44958,TC20,5000,5,5000,0
14392892,44957,TC20,5000,4,4000,1000
14353298,44942,TC26,7000,5,5000,2000
14479876,44991,TC26,5000,5,5000,0
14527854,45009,TC26,5000,4,4000,1000
14524416,45005,TC26,5000,4,4000,1000
14518995,45006,TC20,5000,4,4000,1000
14325343,44929,TC20,5000,5,5000,0
14421446,44966,TC20,5000,3,3000,2000
14387172,44952,TC40,32000,31,31000,1000
14482531,44993,TC40,30600,30,30000,600
14472239,44986,TC40,27600,27,27000,600
14488190,44992,TC40,35000,35,35000,0
14442308,44978,TC40,30500,30,30000,500
14325505,44929,TC40,32000,32,32000,0
14325505,44929,TC40,32000,,32000,0
14325500,44928,TC40,35000,35,35000,0
14362558,44943,TC40,34000,30,30000,4000
14482521,44992,TC40,26500,26,26000,500
14453035,44979,TC40,29600,30,30000,-400
14482520,44991,TC40,30650,30,30000,650
14482519,44992,TC40,26600,28,28000,-1400
14373268,44946,TC40,35000,35,35000,0
14397074,44957,TC40,35000,35,35000,0
14472241,44987,TC40,30600,31,31000,-400
14325503,44928,TC40,35000,35,35000,0
14333059,44931,TC40,35000,35,35000,0
14421487,44984,TC40,30600,31,31000,-400
14347802,44937,TC40,34000,32,32000,2000
14526115,45006,TC40,30420,30,30000,420
14472255,44987,TC40,29600,30,30000,-400
14460587,44980,TC20,5000,5,5000,0
14362052,44944,TC20,5000,5,5000,0
14346410,44938,TC20,5000,5,5000,0
14419733,44967,TC20,5000,5,5000,0
14514944,45002,TC20,5000,5,5000,0
14473476,44988,TC20,5000,5,5000,0
14389189,44952,TC20,5000,5,5000,0
14400084,44960,TC20,5000,5,5000,0
14330409,44931,TC20,5000,4,4000,1000
14494853,44994,TC20,5000,5,5000,0
14491872,44995,CON30,4000,4,4000,0
14503109,44995,TRA,7000,,7000,0
14517178,45008,TRA,31150,30,30000,1150
14375895,44949,TRA,35100,28,28000,7100
14534853,45009,TRA,30336,,30336,0
14514064,45000,TRA,7000,7,7000,0
14514064,45000,TRA,7000,,7000,0
14409158,44960,TRA,37100,30,30000,7100
14366529,44943,TRA,22000,8,8000,14000
14375904,44949,TRA,15700,8,8000,7700
14510030,44999,KTA,35000,25,25000,10000
14512892,45000,KTA,35000,22,22000,13000
14471837,44985,KTA,35000,22,22000,13000
14398024,44957,TRA,25000,24,24000,1000
14368398,44944,TRA,15000,7,7000,8000
14485395,44991,TRA,16000,30,30000,-14000
14489842,44992,TC20,21000,,21000,0
14489842,44992,TC20,21000,22,22000,-1000
14375840,44949,TC20,29150,30,30000,-850
14472384,44987,TC20,29150,29,29000,150
14442572,44980,TC26,35720,32,32000,3720
14472243,44995,TC20,26060,26,26000,60
14404868,44959,CON20,5184,,5184,0
14357669,44943,TC20,32000,28,28000,4000
14367385,44949,TC20,33000,28,28000,5000
14517282,45002,TC20,5000,5,5000,0
14370660,44946,TC20,34000,,34000,0
14370660,44946,TC20,34000,,34000,0
14370660,44946,TC20,34000,,34000,0
14370660,44946,TC20,34000,29,29000,5000
14370660,44946,TC20,34000,,34000,0
14478971,44995,TC20,25000,25,25000,0
14478972,44998,TC20,25000,25,25000,0
14459967,44980,TC26,27120,28,28000,-880
14490318,44998,TC26,25986,25,25000,986
14370568,44945,TC23,26000,26,26000,0
14464142,44986,TC23,33000,33,33000,0
14340301,44931,CON20,4000,3,3000,1000
14469340,44984,KTA,35000,28,28000,7000
14488092,44991,KTA,35000,16,16000,19000
14502436,44995,KTA,35000,18,18000,17000
14520251,45002,KTA,35000,17,17000,18000
14339474,44938,CON30,30570,31,31000,-430
14415179,44965,CON30,31470,30,30000,1470
14353286,44945,CON30,28530,31,31000,-2470
14368760,44952,CON30,31310,31,31000,310
14402403,44964,CON30,31470,31,31000,470
14402404,44963,CON30,27750,30,30000,-2250
14339475,44939,CON30,31030,31,31000,30
14408847,44963,CON30,28170,28,28000,170
14368759,44951,CON30,29990,30,30000,-10
14353284,44946,CON45,31500,30,30000,1500
14525652,45006,CON30,30490,30,30000,490
14389126,44956,CON30,31270,31,31000,270
14524250,45008,CON30,29990,31,31000,-1010
14458970,44986,CON30,27850,27,27000,850
14496906,44998,CON30,30730,31,31000,-270
14458969,44984,CON30,27890,28,28000,-110
14328668,44930,CON30,28640,29,29000,-360
14339464,44937,CON30,29880,31,31000,-1120
14444309,44978,CON30,30300,31,31000,-700
14353285,44945,CON30,31160,31,31000,160
14371859,44949,CON30,30620,30,30000,620
14389135,44958,CON30,31280,31,31000,280
14419825,44966,CON30,31220,32,32000,-780
14389129,44957,CON30,31180,31,31000,180
14524244,45006,CON30,27360,27,27000,360
14353283,44946,CON30,29280,30,30000,-720
14368762,44951,CON30,29820,30,30000,-180
14363152,44942,SWAP20,15000,15,15000,0
14347455,44936,SWAP20,11000,10,10000,1000
14418328,44964,SWAP20,11000,9,9000,2000
14507829,44998,SWAP20,12000,19,19000,-7000
14453587,44978,SWAP20,14000,19,19000,-5000
14472380,44985,SWAP20,12000,11,11000,1000
14473713,44985,TRA,32000,16,16000,16000
14517627,45001,TRA,28000,18,18000,10000
14517627,45001,TRA,28000,,28000,0
14519306,45002,TRA,28000,,28000,0
14519306,45002,TRA,28000,22,22000,6000
14492090,44992,TRA,32000,32,32000,0
14492090,44992,TRA,32000,30,30000,2000
14492090,44992,TRA,32000,,32000,0
14397308,44956,TRA,32000,17,17000,15000
14340726,44934,TRA,35000,19,19000,16000
14331063,44928,SWAP20,15000,9,9000,6000
14349907,44937,SWAP20,15000,9,9000,6000
14382996,44950,SWAP20,15000,10,10000,5000
14492272,44992,SWAP20,8000,9,9000,-1000
14452499,44977,SWAP20,12000,10,10000,2000
14524479,45005,SWAP20,12000,14,14000,-2000
14524481,45005,SWAP20,8000,10,10000,-2000
14538149,45009,SWAP20,10000,,10000,0
14442245,44973,SWAP20,8000,8,8000,0
14465313,44981,SWAP20,12000,13,13000,-1000
14488816,44991,SWAP20,12000,10,10000,2000
14405131,44959,SWAP20,10000,12,12000,-2000
14521324,45002,SWAP20,12000,10,10000,2000
14502785,44995,SWAP20,8000,,8000,0
14462687,44980,SWAP20,11000,11,11000,0
14434789,44970,SWAP20,10000,12,12000,-2000
14442244,44973,SWAP20,12000,9,9000,3000
14472382,44985,SWAP20,12000,8,8000,4000
14510468,44999,SWAP20,10000,9,9000,1000
14492271,44992,SWAP20,10000,8,8000,2000
14418330,44964,SWAP20,11000,8,8000,3000
14349255,44936,SWAP20,15000,8,8000,7000
14528500,45006,SWAP20,8000,5,5000,3000
14529779,45006,SWAP20,8000,8,8000,0
14331062,44928,SWAP20,15000,19,19000,-4000
14384204,44950,SWAP20,15000,14,14000,1000
14507340,44998,SWAP20,12000,13,13000,-1000
14455868,44978,SWAP20,9000,7,7000,2000
14461452,44980,SWAP20,11000,8,8000,3000
14434790,44970,SWAP20,10000,11,11000,-1000
14521326,45002,SWAP20,12000,140,14000,-2000
14488906,44991,SWAP20,12000,10,10000,2000
14406070,44959,SWAP20,12000,12,12000,0
14338143,44930,SWAP20,11000,6,6000,5000
14363154,44942,SWAP20,15000,15,15000,0
14497156,45002,TC20,5000,4,4000,1000
14451419,44985,TC20,5000,5,5000,0
14460196,45000,TC23,10000,10,10000,0
14434809,44974,TC23,5000,5,5000,0
14348840,44944,TC23,5000,5,5000,0
14473155,44994,TC23,25300,21,21000,4300
14443050,44981,TC23,20000,20,20000,0
14338844,44936,TC23,25000,21,21000,4000
14525446,45005,CON20,2000,3,3000,-1000
14525446,45005,CON20,2000,,2000,0
14525446,45005,CON20,2000,,2000,0
14525446,45005,CON20,2000,,2000,0
14525102,45005,CON20,21163,22,22000,-837
14345169,44935,CON20,4000,3,3000,1000
14397515,44957,TC20,25000,25,25000,0
14400210,44960,TC20,29000,29,29000,0
14339482,44939,CON30,4000,4,4000,0
14421511,44966,CON30,4000,3,3000,1000
14461484,44986,CON30,4000,4,4000,0
14493084,45000,CON30,4000,4,4000,0
14331966,44936,CON30,4000,3,3000,1000
14361492,44946,CON30,4000,4,4000,0
14465256,44984,CON30,4000,4,4000,0
14458621,44992,CON30,4000,4,4000,0
14348902,44946,CON30,4000,4,4000,0
14339481,44943,CON30,4000,4,4000,0
14400350,44964,CON30,4000,4,4000,0
14460866,44981,CON30,4000,4,4000,0
14478772,44991,CON30,4000,4,4000,0
14471601,44993,CON30,4000,4,4000,0
14322784,44928,CON30HC,4000,4,4000,0
14471669,44986,CON30,4000,4,4000,0
14446518,44978,CON30,4000,4,4000,0
14471670,44986,CON30,4000,4,4000,0
14458622,44991,CON30,4000,4,4000,0
14348901,44944,TC30,7000,4,4000,3000
14339483,44939,CON30,4000,4,4000,0
14488395,45000,TC20,26350,26,26000,350
14353789,44943,CON30,4000,4,4000,0
14453003,44978,SWAP20,8000,,8000,0
14453003,44978,SWAP20,8000,6,6000,2000
14477659,44991,SWAP20,5000,,5000,0
14477659,44991,SWAP20,5000,3,3000,2000
14361087,44943,SWAP20,8000,4,4000,4000
14453008,44978,SWAP20,8000,4,4000,4000
14408370,44963,CON30,3000,3,3000,0
14335814,44995,CON30,3000,2,2000,1000
14318655,44970,CON30,3000,6,6000,-3000
14243996,44936,CON30,3000,3,3000,0
14243887,44935,CON30,3000,3,3000,0
14334049,44974,CON30,3000,5,5000,-2000
14429253,45008,CON30,3000,4,4000,-1000
14333516,44978,CON30,1900,4,4000,-2100
14251083,44944,CON30,1900,1,1000,900
14243908,44935,CON30,1900,1,1000,900
14316705,44949,CON30,1900,5,5000,-3100
14317832,44960,CON30,1900,4,4000,-2100
14244145,44937,CON30,1900,4,4000,-2100
14428407,45000,CON30,1900,2,2000,-100
14333755,44980,CON30,1900,2,2000,-100
14362882,44944,CON30,1900,1,1000,900
14333384,44977,CON30,1900,1,1000,900
14244151,44937,CON30,1900,2,2000,-100
14428677,45002,CON30,1900,2,2000,-100
14428677,45002,CON30,1900,,1900,0
14244261,44938,CON30,1900,2,2000,-100
14317601,44958,CON30,1900,4,4000,-2100
14428858,45005,CON30,1900,2,2000,-100
14317606,44958,CON30,3000,4,4000,-1000
14335107,44987,CON30,3000,3,3000,0
14335577,44993,CON30,3000,3,3000,0
14334286,44972,CON30,3000,4,4000,-1000
14334431,44981,CON30,3000,4,4000,-1000
14428156,44998,CON30,3000,3,3000,0
14335101,44987,CON30,3000,3,3000,0
14317838,44960,CON30,3000,3,3000,0
14244388,44939,CON30,1900,6,6000,-4100
14334714,44985,CON30,1900,4,4000,-2100
14333379,44977,CON30,3000,4,4000,-1000
14428146,44998,CON30,3000,3,3000,0
14334621,44984,CON30,3000,5,5000,-2000
14244267,44938,CON30,3000,3,3000,0
14317204,44953,CON30,3000,5,5000,-2000
14316708,44949,CON30,3000,5,5000,-2000
14251650,44942,CON30,3000,3,3000,0
14316960,44951,CON30,3000,3,3000,0
14334719,44985,CON30,3000,5,5000,-2000
14335332,44991,CON30,3000,3,3000,0
14318649,44970,CON30,3000,3,3000,0
14362881,44946,CON30,3000,3,3000,0
14318246,44965,CON30,3000,4,4000,-1000
14243508,44929,CON30,3000,3,3000,0
14333510,44978,CON30,3000,3,3000,0
14429254,45008,CON30,3000,4,4000,-1000
14428967,45006,CON30,3000,4,4000,-1000
14243356,44929,CON30,3000,3,3000,0
14317451,44957,CON30,3000,3,3000,0
14251652,44942,CON30,3000,4,4000,-1000
14364632,44949,CON30,4000,4,4000,0
14364636,44949,CON30,4000,4,4000,0
14364639,44949,CON30,4000,4,4000,0
14364633,44949,CON30,4000,4,4000,0
14362112,44942,CON30,34000,29,29000,5000
14459940,44984,CON30,33000,,33000,0
14459940,44984,CON30,33000,,33000,0
14459940,44984,CON30,33000,28,28000,5000
14364640,44949,CON30,4000,4,4000,0
14357626,44942,CON30,34000,30,30000,4000
14407764,44964,TC30,37000,29,29000,8000
14379039,44949,CON30,34000,,34000,0
14379039,44949,CON30,34000,30,30000,4000
14472493,44988,TC30,30000,29,29000,1000
14364638,44949,CON30,4000,3,3000,1000
14364635,44949,CON30,4000,4,4000,0
14364631,44949,CON30,4000,4,4000,0
14487505,44992,CON30,27000,30,30000,-3000
14364637,44949,CON30,4000,4,4000,0
14398780,44957,CON30,29000,27,27000,2000
14331757,44931,CON30,34000,28,28000,6000
14364634,44949,CON30,4000,3,3000,1000
14389062,44952,CON30,34000,29,29000,5000
14370681,44949,TC30,35000,,35000,0
14370681,44949,TC30,35000,29,29000,6000
14508375,44999,TC30,31000,28,28000,3000
14391655,44953,CON30,32000,29,29000,3000
14355227,44942,CON30,33000,30,30000,3000
14516555,45005,TC30,29000,27,27000,2000
14432959,44974,TC30,35000,28,28000,7000
14444568,44979,CON30,4000,3,3000,1000
14392839,44957,CON30,29280,30,30000,-720
14493152,44993,CON30,27900,,27900,0
14493152,44993,CON30,27900,,27900,0
14493152,44993,CON30,27900,25,25000,2900
14426680,44972,CON30,31000,28,28000,3000
14362948,44943,CON30,31000,28,28000,3000
14527786,45008,TC30,29000,28,28000,1000
14392306,44957,CON30,4000,4,4000,0
14386063,44951,CON30,33000,29,29000,4000
14386063,44951,CON30,33000,,33000,0
14515726,45008,CON30,29280,29,29000,280
14516930,45006,CON30,24900,29,29000,-4100
14426444,44970,CON30,30900,28,28000,2900
14336287,44930,CON30,30900,28,28000,2900
14463979,44985,CON30,30900,30,30000,900
14369420,44946,TC30,35000,28,28000,7000
14444171,44977,CON30,29900,28,28000,1900
14369415,44946,CON30,32000,30,30000,2000
14471450,44991,TC30,28000,29,29000,-1000
14527817,45009,TC30,29000,28,28000,1000
14527817,45009,TC30,29000,,29000,0
14345504,44936,CON30,28630,28,28000,630
14408531,44960,CON30,4000,3,3000,1000
14347497,44937,CON30,32000,30,30000,2000
14426433,44970,CON30,32000,29,29000,3000
14510057,45001,TC30,29000,28,28000,1000
14380067,44951,CON30,4000,4,4000,0
14413811,44965,CON30,29280,30,30000,-720
14344392,44936,CON30,32000,29,29000,3000
14408057,44966,TC30,35000,29,29000,6000
14330820,44930,CON30,32000,29,29000,3000
14426445,44970,CON30,31000,28,28000,3000
14509805,45000,TC30,29000,28,28000,1000
14496310,44994,CON30,27000,28,28000,-1000
14328047,44929,TC30,35000,29,29000,6000
14382304,44952,TC30,35000,28,28000,7000
14456679,44984,TC30,35000,28,28000,7000
14408533,44960,CON30,4000,3,3000,1000
14362949,44944,CON30,32000,28,28000,4000
14445491,44978,CON30,33000,30,30000,3000
14501872,44995,CON30,30000,30,30000,0
14510106,45002,TC30,29000,29,29000,0
14408086,44967,TC30,35000,29,29000,6000
14458494,44981,CON30,29280,29,29000,280
14347685,44938,CON30,29900,28,28000,1900
14432910,44973,TC30,35000,28,28000,7000
14396394,44956,CON30,4000,3,3000,1000
14391653,44953,CON30,33000,30,30000,3000
14396718,44956,CON30,32000,28,28000,4000
14325973,44930,CON30,29900,31,31000,-1100
14375269,44950,TC30,35000,28,28000,7000
14471419,44987,TC30,30000,30,30000,0
14370678,44949,CON30,31000,28,28000,3000
14370678,44949,CON30,31000,,31000,0
14471425,44987,TC30,30000,30,30000,0
14408528,44963,CON30,4000,4,4000,0
14409308,44964,CON30,4000,4,4000,0
14380239,44951,CON30,32000,28,28000,4000
14471448,44991,TC30,29000,30,30000,-1000
14336283,44930,CON30,33000,30,30000,3000
14392312,44960,CON30,24900,25,25000,-100
14396355,44958,CON30,30900,28,28000,2900
14338717,44935,TC30,35000,28,28000,7000
14510046,45001,TC30,29000,28,28000,1000
14481443,44988,TC30,30000,30,30000,0
14328034,44929,TC30,35000,28,28000,7000
14382296,44952,TC30,35000,29,29000,6000
14456677,44984,CON30,33000,30,30000,3000
14370674,44949,TC30,35000,28,28000,7000
14370674,44949,TC30,35000,,35000,0
14402310,44958,CON30HC,30000,26,26000,4000
14514038,45005,CON30,4000,4,4000,0
14370677,44949,TC30,35000,,35000,0
14370677,44949,TC30,35000,,35000,0
14370677,44949,TC30,35000,28,28000,7000
14527810,45009,TC30,28000,,28000,0
14527810,45009,TC30,28000,28,28000,0
14527810,45009,TC30,28000,28,28000,0
14433081,44972,CON30,4000,4,4000,0
14496335,44998,CON30,4000,4,4000,0
14464255,44986,CON30,33000,30,30000,3000
14375275,44950,CON30,31000,28,28000,3000
14355229,44942,CON30,32000,30,30000,2000
14426682,44972,CON30,32000,28,28000,4000
14364958,44950,CON30,30880,30,30000,880
14347540,44937,CON30,33000,28,28000,5000
14408058,44966,TC30,35000,28,28000,7000
14496534,44995,TC30,28000,28,28000,0
14391642,44953,CON30,32000,28,28000,4000
14471444,44991,TC30,29000,30,30000,-1000
14527816,45009,TC30,28000,,28000,0
14527816,45009,TC30,28000,28,28000,0
14362095,44946,CON30,30880,31,31000,-120
14356757,44944,CON30,30880,31,31000,-120
14379940,44951,CON30,4000,4,4000,0
14396221,44958,CON30,32000,28,28000,4000
14326524,44928,CON30,32000,28,28000,4000
14487982,44993,CON30,25000,28,28000,-3000
14487982,44993,CON30,25000,,25000,0
14434416,44972,CON30,4000,4,4000,0
14330835,44930,CON30,31000,28,28000,3000
14392261,44957,CON30,32000,28,28000,4000
14389089,44952,CON30,34000,31,31000,3000
14463974,44985,CON30,32000,29,29000,3000
14390711,44956,CON30,4000,4,4000,0
14463976,44985,CON30,33000,30,30000,3000
14369419,44946,TC30,34000,28,28000,6000
14422337,44967,CON30,29280,29,29000,280
14434393,44971,CON30,4000,3,3000,1000
14426590,44971,CON30,32000,28,28000,4000
14351522,44939,CON30,33000,29,29000,4000
14426323,44967,CON30,23900,26,26000,-2100
14347543,44937,CON30,32000,28,28000,4000
14408028,44965,TC30,35000,28,28000,7000
14496537,44995,TC30,28000,28,28000,0
14445502,44979,CON30,31000,28,28000,3000
14516928,45006,TC30,29000,28,28000,1000
14364877,44945,TC30,35000,28,28000,7000
14326521,44928,CON30,32000,28,28000,4000
14396984,44956,CON30,32000,28,28000,4000
14392263,44957,CON30,32000,29,29000,3000
14336304,44931,CON30,32000,28,28000,4000
14382490,44950,CON30,34000,31,31000,3000
14364310,44951,CON30,29280,29,29000,280
14422343,44970,CON30,4000,4,4000,0
14456692,44984,TC30,34000,529,52900,-18900
14375373,44953,CON30,29280,30,30000,-720
14375274,44950,CON30,31000,28,28000,3000
14375274,44950,CON30,31000,28,28000,3000
14509807,45000,TC30,28000,28,28000,0
14496360,44994,CON,27000,30,30000,-3000
14434389,44973,CON30,4000,4,4000,0
14532254,45009,CON30,4000,4,4000,0
14530455,45007,CON30,26900,28,28000,-1100
14530455,45007,CON30,26900,27,27000,-100
14391644,44953,CON30,32000,28,28000,4000
14432967,44970,TC30,34000,28,28000,6000
14347538,44937,CON30,31000,28,28000,3000
14408054,44966,TC30,36000,29,29000,7000
14510048,45001,TC30,29000,,29000,0
14510048,45001,TC30,29000,,29000,0
14510048,45001,TC30,29000,28,28000,1000
14516929,45006,CON30,26000,29,29000,-3000
14444180,44977,CON30,31000,28,28000,3000
14362957,44944,CON30,32000,28,28000,4000
14464297,44986,CON30,33000,28,28000,5000
14464337,44986,CON30,32000,29,29000,3000
14380231,44951,CON30,32000,29,29000,3000
14456690,44984,CON30,32000,28,28000,4000
14426683,44972,CON30,32000,29,29000,3000
14357765,44943,TC30,35000,28,28000,7000
14527785,45008,TC30,29000,28,28000,1000
14488443,44995,CON30,4000,4,4000,0
14353408,44942,CON30,29280,30,30000,-720
14330821,44930,CON30,31000,29,29000,2000
14396688,44956,CON30,32000,28,28000,4000
14364957,44950,CON30,29280,30,30000,-720
14344387,44936,CON30,33000,30,30000,3000
14404619,44963,CON30,32000,29,29000,3000
14510033,45001,TC30,29000,28,28000,1000
14380221,44951,CON30,31000,29,29000,2000
14477667,44992,TC30,30000,29,29000,1000
14466304,44988,CON30,29900,,29900,0
14466304,44988,CON30,29900,30,30000,-100
14326322,44929,CON30,29280,30,30000,-720
14396624,44956,CON30,32000,28,28000,4000
14488394,44993,CON30,4000,4,4000,0
14494392,44993,CON30,27000,27,27000,0
14481437,44988,TC30,30000,30,30000,0
14369412,44946,TC30,35000,28,28000,7000
14445486,44978,CON30,32000,30,30000,2000
14516560,45005,TC30,29000,29,29000,0
14364861,44945,TC30,35000,28,28000,7000
14434631,44972,CON30,4000,4,4000,0
14369416,44946,CON30,33000,29,29000,4000
14369416,44946,CON30,33000,,33000,0
14453571,44981,TC30,34000,29,29000,5000
14357772,44943,CON30,32000,28,28000,4000
14432909,44973,TC30,34000,28,28000,6000
14510121,45002,TC30,29000,,29000,0
14510121,45002,TC30,29000,29,29000,0
14516559,45005,TC30,29000,29,29000,0
14432906,44973,TC30,36000,29,29000,7000
14351523,44939,TC30,34000,29,29000,5000
14463971,44985,CON30,32000,29,29000,3000
14471420,44987,TC30,29000,29,29000,0
14347636,44938,CON30,32000,28,28000,4000
14408027,44965,TC30,35000,30,30000,5000
14508383,44999,TC30,29000,28,28000,1000
14364960,44950,CON30,29280,29,29000,280
14426593,44971,CON30,31000,28,28000,3000
14515723,45007,CON30,29280,30,30000,-720
14347549,44937,CON30,32000,30,30000,2000
14408083,44967,TC30,35000,29,29000,6000
14512151,45006,CON30,29280,30,30000,-720
14444570,44979,CON30,4000,3,3000,1000
14413787,44966,CON30,29280,30,30000,-720
14347679,44938,CON30,32000,28,28000,4000
14426595,44971,CON30,33000,30,30000,3000
14510054,45001,TC30,29000,28,28000,1000
14396401,44957,CON30,4000,4,4000,0
14330819,44929,CON30,31000,28,28000,3000
14426585,44971,CON30,32000,28,28000,4000
14443657,44978,CON30,29280,29,29000,280
14336306,44931,CON30,32000,29,29000,3000
14407773,44964,TC30,35000,28,28000,7000
14490786,44994,TC30,28000,28,28000,0
14520088,45002,CON30,4000,3,3000,1000
14416314,44967,CON30,4000,5,5000,-1000
14469588,44986,CON30,26000,28,28000,-2000
14327213,44928,CON30,29280,29,29000,280
14445506,44979,CON30,31000,28,28000,3000
14326511,44928,CON30,32000,28,28000,4000
14392260,44957,CON30,32000,29,29000,3000
14527565,45006,CON30,31000,28,28000,3000
14519339,45008,CON30,29280,30,30000,-720
14477671,44993,CON30,29280,30,30000,-720
14362952,44944,CON30,32000,28,28000,4000
14432962,44974,TC30,35000,28,28000,7000
14347551,44937,CON30,33000,31,31000,2000
14408024,44965,TC30,36000,30,30000,6000
14509802,45000,TC30,28000,27,27000,1000
14435034,44970,CON30,4000,3,3000,1000
14471417,44987,TC30,29000,29,29000,0
14375260,44950,TC30,6000,30,30000,-24000
14370682,44949,CON30,33000,,33000,0
14370682,44949,CON30,33000,30,30000,3000
14370682,44949,CON30,33000,,33000,0
14498061,44998,TC30,29000,28,28000,1000
14498061,44998,TC30,29000,,29000,0
14326518,44928,CON30,32000,30,30000,2000
14380225,44951,CON30,32000,29,29000,3000
14471447,44991,TC30,29000,30,30000,-1000
14374953,44946,CON30,30000,25,25000,5000
14408532,44963,CON30,4000,4,4000,0
14351533,44939,CON30,32000,28,28000,4000
14444164,44977,CON30,33000,30,30000,3000
14519430,45007,CON30,26000,27,27000,-1000
14327212,44928,CON30,29280,30,30000,-720
14446524,44978,CON30,4000,4,4000,0
14487973,44993,CON30,25000,28,28000,-3000
14487973,44993,CON30,25000,,25000,0
14330841,44930,CON30,32000,28,28000,4000
14398853,44960,CON30,27000,27,27000,0
14409113,44964,CON30,30380,30,30000,380
14461382,44984,CON30,29900,30,30000,-100
14399174,44959,CON30,29280,30,30000,-720
14443653,44978,CON30,29280,30,30000,-720
14453568,44981,TC30,34000,28,28000,6000
14369418,44946,TC30,35000,28,28000,7000
14382297,44952,CON30,32000,31,31000,1000
14496525,44995,TC30,28000,28,28000,0
14344394,44936,CON30,32000,29,29000,3000
14519427,45007,TC30,29000,29,29000,0
14453559,44980,TC30,36000,30,30000,6000
14453555,44980,TC30,34000,28,28000,6000
14519424,45007,TC30,29000,29,29000,0
14364881,44945,TC30,35000,29,29000,6000
14503439,45002,CON30,29280,30,30000,-720
14397160,44958,CON30,29280,30,30000,-720
14327218,44929,CON30,29280,29,29000,280
14326527,44928,CON30,32000,28,28000,4000
14391658,44953,CON30,32000,29,29000,3000
14407769,44964,TC30,35000,28,28000,7000
14328055,44929,TC30,35000,28,28000,7000
14445493,44978,CON30,31000,28,28000,3000
14516931,45006,TC30,29000,30,30000,-1000
14364865,44945,TC30,35000,28,28000,7000
14347674,44938,TC30,36000,28,28000,8000
14408088,44967,TC30,35000,29,29000,6000
14527767,45008,TC30,29000,28,28000,1000
14416313,44967,CON30,4000,4,4000,0
14396269,44958,CON30,32000,29,29000,3000
14338718,44935,TC30,36000,30,30000,6000
14508359,44999,TC30,31000,29,29000,2000
14392305,44957,CON30,4000,4,4000,0
14337310,44930,CON30,33000,31,31000,2000
14406019,44963,CON30,29280,29,29000,280
14355191,44942,CON30,33000,30,30000,3000
14432904,44973,TC30,34000,27,27000,7000
14398855,44960,CON30,28000,28,28000,0
14527819,45009,TC30,29000,,29000,0
14527819,45009,TC30,29000,29,29000,0
14347642,44938,CON30,32000,28,28000,4000
14353407,44942,CON30,29900,29,29000,900
14333314,44936,CON30,4000,3,3000,1000
14471410,44991,CON30,29280,29,29000,280
14453569,44981,TC30,36000,30,30000,6000
14392259,44957,CON30,33000,28,28000,5000
14527815,45009,TC30,29000,28,28000,1000
14527815,45009,TC30,29000,,29000,0
14489820,44998,CON30,29280,30,30000,-720
14464136,44986,CON30,33000,30,30000,3000
14375250,44950,CON30,33000,30,30000,3000
14364879,44945,TC30,35000,28,28000,7000
14456678,44984,TC30,35000,,35000,0
14456678,44984,TC30,35000,30,30000,5000
14396637,44959,CON30,32000,30,30000,2000
14370683,44949,CON30,32000,,32000,0
14370683,44949,CON30,32000,30,30000,2000
14370683,44949,CON30,32000,,32000,0
14471422,44987,TC30,29000,28,28000,1000
14465093,44985,CON30,4000,4,4000,0
14396721,44956,CON30,32000,29,29000,3000
14477669,44993,CON30,29280,30,30000,-720
14438710,44972,CON30,4000,4,4000,0
14408526,44964,CON30,4000,4,4000,0
14407775,44964,TC30,35000,29,29000,6000
14519432,45007,TC30,29000,,29000,0
14519432,45007,TC30,29000,29,29000,0
14404616,44963,CON30,33000,29,29000,4000
14336301,44931,CON30,32000,30,30000,2000
14490791,44994,TC30,29000,28,28000,1000
14397168,44959,CON30,29280,29,29000,280
14404615,44963,CON30,32000,28,28000,4000
14490776,44994,TC30,28000,28,28000,0
14396670,44959,CON30,33000,30,30000,3000
14330845,44930,CON30,32000,29,29000,3000
14498063,44998,TC30,29000,29,29000,0
14510110,45002,TC30,28000,,28000,0
14510110,45002,TC30,28000,29,29000,-1000
14432952,44974,TC30,35000,29,29000,6000
14364870,44945,TC30,35000,29,29000,6000
14344388,44936,CON30,32000,29,29000,3000
14407767,44964,TC30,35000,28,28000,7000
14407767,44964,TC30,35000,30,30000,5000
14362055,44944,CON30,29280,29,29000,280
14362091,44949,CON30,29280,30,30000,-720
14396223,44956,CON30,4000,4,4000,0
14458492,44981,CON30,29280,30,30000,-720
14396358,44958,CON30,33000,30,30000,3000
14338708,44935,TC30,35000,28,28000,7000
14490784,44994,TC30,28000,29,29000,-1000
14489821,44998,CON30,29280,30,30000,-720
14375951,44953,CON30,29280,30,30000,-720
14336305,44931,CON30,32000,28,28000,4000
14408049,44965,TC30,35000,29,29000,6000
14496539,44995,TC30,28000,,28000,0
14496539,44995,TC30,28000,,28000,0
14496539,44995,TC30,28000,28,28000,0
14498066,44998,TC30,29000,29,29000,0
14408093,44967,TC30,35000,29,29000,6000
14338721,44935,TC30,35000,28,28000,7000
14344385,44936,CON30,32000,28,28000,4000
14398851,44960,CON30,28000,28,28000,0
14516558,45005,CON30,27000,,27000,0
14516558,45005,CON30,27000,28,28000,-1000
14355210,44942,CON30,32000,28,28000,4000
14432912,44973,TC30,36000,29,29000,7000
14487975,44993,CON30,25000,28,28000,-3000
14487975,44993,CON30,25000,28,28000,-3000
14487975,44993,CON30,25000,,25000,0
14396644,44959,CON30,32000,29,29000,3000
14344390,44936,CON30,33000,29,29000,4000
14408081,44967,TC30,35000,28,28000,7000
14508369,44999,TC30,31000,28,28000,3000
14458584,44981,CON30,29280,30,30000,-720
14398978,44960,CON30,4000,4,4000,0
14336285,44930,CON30,32000,28,28000,4000
14392266,44957,TC30,36000,29,29000,7000
14498058,44998,TC30,29000,28,28000,1000
14463969,44985,CON30,32000,28,28000,4000
14327216,44928,CON30,29280,29,29000,280
14462003,44984,CON30,4000,4,4000,0
14519336,45008,CON30,29280,29,29000,280
14372156,44949,CON30,29280,30,30000,-720
14404620,44963,CON30,32000,29,29000,3000
14487980,44993,CON30,25000,,25000,0
14487980,44993,CON30,25000,28,28000,-3000
14487980,44993,CON30,25000,28,28000,-3000
14487980,44993,CON30,25000,,25000,0
14481438,44988,TC30,30000,30,30000,0
14364535,44943,CON30,33000,30,30000,3000
14327215,44929,CON30,29280,29,29000,280
14336298,44931,CON30,32000,29,29000,3000
14510101,45002,TC30,29000,29,29000,0
14432569,44970,TC30,34000,32,32000,2000
14466301,44988,CON30,29280,30,30000,-720
14488393,44993,CON30,4000,3,3000,1000
14426441,44970,CON30,32000,28,28000,4000
14351528,44939,CON30,33000,29,29000,4000
14509806,45000,TC30,29000,29,29000,0
14375955,44951,CON30,29280,29,29000,280
14364322,44949,CON30,29280,30,30000,-720
14364322,44949,CON30,29280,,29280,0
14357770,44943,CON30,32000,29,29000,3000
14445503,44979,CON30,31000,29,29000,2000
14362090,44946,CON30,29280,30,30000,-720
14416925,44964,CON30,30000,27,27000,3000
14481491,44994,CON30,29280,30,30000,-720
14445489,44978,CON30,31000,28,28000,3000
14355172,44942,TC30,35000,30,30000,5000
14364266,44949,CON30,29280,30,30000,-720
14364266,44949,CON30,29280,,29280,0
14396666,44959,CON30,32000,29,29000,3000
14338723,44935,TC30,35000,30,30000,5000
14338720,44935,TC30,35000,28,28000,7000
14408059,44966,TC30,35000,29,29000,6000
14408056,44966,TC30,35000,29,29000,6000
14508380,44999,TC30,29000,28,28000,1000
14375365,44953,CON30,29280,30,30000,-720
14382298,44952,TC30,35000,29,29000,6000
14328036,44929,TC30,34000,30,30000,4000
14472511,44992,TC30,30000,28,28000,2000
14408525,44964,CON30,4000,4,4000,0
14514826,45004,CON30,30600,30,30000,600
14406020,44963,CON30,29280,30,30000,-720
14461378,44984,CON30,29280,30,30000,-720
14474289,44993,CON30,29280,30,30000,-720
14445504,44979,CON30,32000,30,30000,2000
14362958,44944,TC30,34000,29,29000,5000
14351527,44939,CON30,31000,28,28000,3000
14426684,44972,CON30,33000,30,30000,3000
14519428,45007,CON30,25000,28,28000,-3000
14353410,44942,CON30,29280,30,30000,-720
14336303,44931,CON30,31000,29,29000,2000
14407771,44964,TC30,35000,28,28000,7000
14498059,44998,TC30,29000,28,28000,1000
14409270,44963,CON30,4000,3,3000,1000
14380235,44951,CON30,32000,28,28000,4000
14477677,44992,TC30,29000,29,29000,0
14367573,44944,CON30,31000,29,29000,2000
14432948,44974,TC30,34000,27,27000,7000
14510115,45002,TC30,29000,30,30000,-1000
14510115,45002,TC30,29000,,29000,0
14327219,44929,CON30,29900,30,30000,-100
14362060,44945,CON30,29280,30,30000,-720
14327217,44929,CON30,29280,29,29000,280
14326528,44928,CON30,32000,28,28000,4000
14396976,44956,CON30,32000,28,28000,4000
14451077,44979,CON30,29280,30,30000,-720
14462563,44985,CON30,29280,30,30000,-720
14458495,44981,CON30,29280,30,30000,-720
14416573,44967,CON30,4000,4,4000,0
14461381,44984,CON30,29280,30,30000,-720
14443651,44978,CON30,29280,30,30000,-720
14463361,44987,CON30,29900,30,30000,-100
14509809,45000,TC30,28000,27,27000,1000
14408022,44965,TC30,34000,29,29000,5000
14328024,44929,TC30,34000,28,28000,6000
14328024,44929,TC30,34000,,34000,0
14402794,44960,CON30,29280,30,30000,-720
14392265,44957,CON30,32000,29,29000,3000
14375303,44950,TC30,36000,29,29000,7000
14477676,44992,TC30,28000,28,28000,0
14432550,44971,CON30,29280,30,30000,-720
14326320,44930,CON30,29280,29,29000,280
14426679,44972,CON30,31000,28,28000,3000
14375954,44951,CON30,29280,30,30000,-720
14375374,44953,CON30,29280,30,30000,-720
14396415,44958,CON30,4000,4,4000,0
14477847,44992,CON30,4000,4,4000,0
14402796,44960,CON30,29280,30,30000,-720
14326323,44930,CON30,29280,29,29000,280
14382306,44952,TC30,34000,,34000,0
14382306,44952,TC30,34000,29,29000,5000
14471442,44991,TC30,29000,30,30000,-1000
14357774,44943,CON30,32000,28,28000,4000
14432964,44974,TC30,34000,29,29000,5000
14516562,45005,TC30,29000,28,28000,1000
14516562,45005,TC30,29000,,29000,0
14451231,44977,CON30,27000,27,27000,0
14451231,44977,CON30,27000,,27000,0
14451076,44979,CON30,29280,30,30000,-720
14443656,44979,CON30,29280,29,29000,280
14380227,44951,CON30,31000,28,28000,3000
14395679,44956,CON30,31000,29,29000,2000
14346151,44938,CON30,4000,4,4000,0
14469317,44986,CON30,4000,4,4000,0
14396172,44958,CON30,32000,28,28000,4000
14462002,44985,CON30,4000,4,4000,0
14466303,44988,CON30,29280,30,30000,-720
14466303,44988,CON30,29280,,29280,0
14432545,44971,CON30,29280,30,30000,-720
14353409,44942,CON30,29280,29,29000,280
14471409,44991,CON30,29280,30,30000,-720
14389484,44956,CON30,29280,29,29000,280
14382301,44952,TC30,35000,28,28000,7000
14481444,44988,TC30,30000,30,30000,0
14355131,44942,CON30,31000,28,28000,3000
14453552,44980,TC30,34000,28,28000,6000
14527782,45008,TC30,29000,28,28000,1000
14327221,44929,CON30,29280,29,29000,280
14479999,44995,CON30,4000,4,4000,0
14328028,44929,TC30,35000,28,28000,7000
14404614,44963,TC30,35000,29,29000,6000
14357773,44943,CON30,32000,28,28000,4000
14444176,44977,CON30,31000,27,27000,4000
14527779,45008,TC30,28000,28,28000,0
14362059,44944,CON30,29280,30,30000,-720
14347682,44938,CON30,31000,28,28000,3000
14481439,44988,TC30,28000,30,30000,-2000
14454390,44979,CON30,29280,30,30000,-720
14494149,44993,CON30,30000,30,30000,0
14426588,44971,CON30,33000,29,29000,4000
14351529,44939,CON30,32000,27,27000,5000
14477670,44993,CON30,29280,30,30000,-720
14391645,44953,CON30,32000,28,28000,4000
14477680,44992,TC30,30000,,30000,0
14477680,44992,TC30,30000,30,30000,0
14423430,44970,CON30,29280,29,29000,280
14454389,44980,CON30,29280,29,29000,280
14398847,44960,CON30,32000,28,28000,4000
14330844,44930,CON30,30000,28,28000,2000
14496532,44995,TC30,28000,29,29000,-1000
14487972,44993,CON30,25000,,25000,0
14487972,44993,CON30,25000,,25000,0
14487972,44993,CON30,25000,28,28000,-3000
14487972,44993,CON30,25000,,25000,0
14487972,44993,CON30,25000,,25000,0
14487972,44993,CON30,25000,,25000,0
14336299,44931,CON30,33000,29,29000,4000
14396658,44959,CON30,31000,28,28000,3000
14422334,44967,CON30,29280,29,29000,280
14362953,44944,TC30,36000,29,29000,7000
14516933,45006,TC30,29000,28,28000,1000
14453556,44980,TC30,34000,28,28000,6000
14392838,44957,CON30,29280,29,29000,280
14462562,44986,CON30,29280,30,30000,-720
14462561,44985,CON30,29280,30,30000,-720
14398848,44960,CON30,27000,28,28000,-1000
14327220,44929,CON30,29280,29,29000,280
14368214,44950,CON30,29280,30,30000,-720
14519338,45009,CON30,29280,29,29000,280
14409306,44965,CON30,4000,4,4000,0
14337942,44935,CON30HC,4000,4,4000,0
14458585,44984,CON30HC,4000,4,4000,0
14496869,44998,CON30HC,4000,4,4000,0
14462136,44981,CON30HC,4000,4,4000,0
14357974,44943,CON30HC,4000,3,3000,1000
14408008,44964,CON30HC,4000,4,4000,0
14494854,44994,CON30HC,4000,3,3000,1000
14408010,44965,CON30HC,4000,3,3000,1000
14358153,44944,CON30HC,4000,4,4000,0
14381725,44953,CON30HC,4000,4,4000,0
14365759,44945,CON30HC,4000,4,4000,0
14331642,44931,CON30HC,4000,3,3000,1000
14327066,44929,CON30HC,4000,3,3000,1000
14372231,44949,CON30HC,4000,4,4000,0
14417304,44966,CON30HC,4000,4,4000,0
14408530,44964,CON30HC,4000,4,4000,0
14362609,44944,CON30HC,4000,4,4000,0
14508440,45001,CON30HC,4000,4,4000,0
14465096,44986,CON30HC,4000,4,4000,0
14426630,44970,CON30HC,4000,4,4000,0
14362608,44944,CON30HC,4000,4,4000,0
14488441,44994,CON30HC,4000,4,4000,0
14365758,44945,CON30HC,4000,4,4000,0
14414895,44967,CON30HC,4000,4,4000,0
14398948,44962,CON30HC,4000,4,4000,0
14523093,45007,CON30HC,4000,4,4000,0
14475505,44987,CON30HC,4000,5,5000,-1000
14475633,44988,CON30HC,4000,4,4000,0
14414673,44963,CON30HC,4000,4,4000,0
14417305,44971,CON30HC,4000,5,5000,-1000
14417305,44971,CON30HC,4000,,4000,0
14417305,44971,CON30HC,4000,,4000,0
14417305,44971,CON30HC,4000,,4000,0
14417305,44971,CON30HC,4000,,4000,0
14417305,44971,CON30HC,4000,,4000,0
14468575,44984,CON30HC,4000,4,4000,0
14345216,44936,CON30HC,4000,4,4000,0
14381335,44952,CON30HC,4000,4,4000,0
14330191,44930,CON30HC,4000,3,3000,1000
14441954,44977,CON30HC,4000,5,5000,-1000
14325073,44928,CON30HC,4000,4,4000,0
14407586,44964,CON30HC,4000,4,4000,0
14407586,44964,CON30HC,4000,,4000,0
14389437,44956,CON30HC,4000,4,4000,0
14347766,44938,CON30HC,4000,4,4000,0
14409307,44965,CON30HC,4000,3,3000,1000
14458734,44981,CON30HC,4000,5,5000,-1000
14399731,44958,CON30HC,4000,3,3000,1000
14399731,44958,CON30HC,4000,,4000,0
14491183,44994,CON30HC,4000,4,4000,0
14327114,44930,CON30HC,4000,3,3000,1000
14325090,44930,CON30HC,4000,4,4000,0
14351694,44941,CON30HC,4000,3,3000,1000
14399694,44958,CON30HC,4000,4,4000,0
14502114,44995,CON30,31000,30,30000,1000
14493481,44993,CON30,30000,,30000,0
14493481,44993,CON30,30000,29,29000,1000
14479973,44992,CON30HC,4000,4,4000,0
14374659,44951,CON30HC,4000,4,4000,0
14337943,44935,CON30HC,4000,4,4000,0
14462018,44984,CON30HC,4000,3,3000,1000
14456686,44981,CON30HC,4000,4,4000,0
14340285,44936,CON30HC,4000,4,4000,0
14380224,44951,CON30HC,4000,4,4000,0
14434632,44973,CON30HC,4000,4,4000,0
14496517,44995,TC30,28000,31,31000,-3000
14488446,44993,CON30HC,4000,3,3000,1000
14517169,45005,CON30HC,4000,4,4000,0
14456613,44980,CON30HC,4000,5,5000,-1000
14409303,44964,CON30HC,4000,4,4000,0
14372233,44950,CON30HC,4000,4,4000,0
14413806,44964,CON30HC,4000,4,4000,0
14385337,44953,CON30HC,4000,4,4000,0
14374660,44950,CON30HC,4000,4,4000,0
14325070,44928,CON30HC,4000,3,3000,1000
14472391,44988,CON30HC,4000,3,3000,1000
14527473,45008,CON30HC,4000,4,4000,0
14435746,44974,CON30HC,4000,5,5000,-1000
14514042,45005,CON30HC,4000,4,4000,0
14351697,44939,CON30HC,4000,4,4000,0
14364237,44949,CON30,32450,30,30000,2450
14395664,44958,CON30HC,4000,3,3000,1000
14392747,44957,CON30HC,4000,4,4000,0
14389441,44956,CON30HC,4000,4,4000,0
14347768,44938,CON30HC,4000,4,4000,0
14441953,44977,CON30HC,4000,5,5000,-1000
14435975,44974,CON30HC,30950,31,31000,-50
14477154,44988,CON30HC,4000,4,4000,0
14376185,44949,CON30HC,4000,4,4000,0
14401621,44960,CON30HC,4000,4,4000,0
14408529,44964,CON30HC,4000,4,4000,0
14330192,44930,CON30HC,4000,4,4000,0
14351695,44941,CON30HC,4000,3,3000,1000
14374662,44950,CON30HC,4000,4,4000,0
14462134,44981,CON30HC,4000,4,4000,0
14340289,44936,CON30HC,4000,4,4000,0
14330949,44935,CON30,30950,28,28000,2950
14402676,44960,CON30HC,4000,3,3000,1000
14353089,44942,CON30HC,4000,4,4000,0
14458587,44984,CON30HC,4000,5,5000,-1000
14414896,44966,CON30HC,4000,3,3000,1000
14386062,44951,TC30,36000,,36000,0
14386062,44951,TC30,36000,30,30000,6000
14488377,44993,CON30HC,4000,4,4000,0
14496928,44994,CON30,30000,30,30000,0
14496909,44999,CON30HC,4000,4,4000,0
14460726,44984,CON30HC,4000,4,4000,0
14365760,44946,CON30HC,4000,4,4000,0
14325089,44928,CON30HC,4000,4,4000,0
14407584,44963,CON30HC,4000,3,3000,1000
14344601,44937,CON30HC,4000,4,4000,0
14340287,44936,CON30HC,4000,4,4000,0
14462001,44986,CON30HC,4000,4,4000,0
14339485,44931,TC30,37000,29,29000,8000
14434418,44972,CON30HC,4000,4,4000,0
14426575,44967,CON30HC,4000,5,5000,-1000
14325072,44928,CON30HC,4000,4,4000,0
14331637,44930,CON30HC,4000,3,3000,1000
14331637,44930,CON30HC,4000,,4000,0
14372232,44949,CON30HC,4000,4,4000,0
14460727,44985,CON30HC,4000,3,3000,1000
14351699,44939,CON30HC,4000,4,4000,0
14353090,44942,CON30HC,4000,4,4000,0
14475631,44988,CON30HC,4000,4,4000,0
14475632,44988,CON30HC,4000,4,4000,0
14381729,44952,CON30HC,4000,4,4000,0
14385339,44953,CON30HC,4000,4,4000,0
14407583,44963,CON30HC,4000,3,3000,1000
14337948,44935,CON30HC,4000,4,4000,0
14365190,44944,CON30HC,4000,4,4000,0
14408009,44964,CON30HC,4000,4,4000,0
14462132,44984,CON30HC,4000,4,4000,0
14502863,44999,CON30HC,4000,4,4000,0
14353088,44942,CON30HC,4000,5,5000,-1000
14506863,45000,CON30HC,4000,4,4000,0
14452632,44979,CON30HC,4000,4,4000,0
14444600,44979,CON30HC,4000,3,3000,1000
14398949,44960,CON30HC,4000,4,4000,0
14381726,44952,CON30HC,4000,4,4000,0
14389438,44956,CON30HC,4000,4,4000,0
14347769,44938,CON30HC,4000,4,4000,0
14414396,44964,CON30HC,4000,4,4000,0
14379944,44950,CON30HC,4000,4,4000,0
14372129,44949,CON30HC,4000,4,4000,0
14414951,44965,CON30HC,4000,3,3000,1000
14330924,44929,CON30HC,4000,4,4000,0
14490305,44993,CON30HC,4000,4,4000,0
14517170,45005,CON30HC,4000,4,4000,0
14441826,44977,CON30HC,4000,4,4000,0
14465104,44985,CON30HC,4000,4,4000,0
14365761,44945,CON30HC,4000,4,4000,0
14413809,44964,CON30HC,4000,4,4000,0
14468576,44984,CON30HC,4000,5,5000,-1000
14395662,44958,CON30HC,4000,3,3000,1000
14347771,44939,CON30HC,4000,4,4000,0
14491184,44994,CON30HC,4000,4,4000,0
14433083,44972,CON30HC,4000,4,4000,0
14357975,44943,CON30HC,4000,4,4000,0
14401622,44959,CON30HC,4000,4,4000,0
14444601,44978,CON30HC,4000,4,4000,0
14488445,44992,CON30HC,4000,4,4000,0
14516308,45002,CON30HC,4000,4,4000,0
14520178,45007,CON30HC,4000,4,4000,0
14462131,44984,CON30HC,4000,4,4000,0
14435745,44974,CON30HC,4000,4,4000,0
14508441,45001,CON30HC,4000,4,4000,0
14353091,44939,CON30HC,4000,4,4000,0
14362816,44944,CON30HC,4000,4,4000,0
14405457,44960,CON30HC,4000,3,3000,1000
14325994,44929,CON30HC,4000,3,3000,1000
14392748,44957,CON30HC,4000,4,4000,0
14437445,44973,CON30HC,4000,4,4000,0
14388864,44959,CON30HC,4000,4,4000,0
14405456,44960,CON30HC,4000,4,4000,0
14381333,44951,CON30HC,4000,4,4000,0
14331647,44931,CON30HC,4000,4,4000,0
14491182,44994,CON30HC,4000,4,4000,0
14382260,44952,CON30HC,4000,4,4000,0
14333312,44935,CON30HC,4000,4,4000,0
14339490,44931,TC30,37000,28,28000,9000
14462017,44984,CON30HC,4000,4,4000,0
14344604,44937,CON30HC,4000,4,4000,0
14531030,45007,CON30,31000,,31000,0
14531030,45007,CON30,31000,30,30000,1000
14531030,45007,CON30,31000,,31000,0
14529164,45006,TRA,32000,31,31000,1000
14344600,44938,CON30HC,4000,,4000,0
14344600,44938,CON30HC,4000,,4000,0
14344600,44938,CON30HC,4000,3,3000,1000
14441955,44977,CON30HC,4000,4,4000,0
14532328,45008,CON30HC,4000,3,3000,1000
14457530,44979,CON30HC,4000,4,4000,0
14426576,44967,CON30HC,4000,4,4000,0
14456687,44981,CON30HC,4000,4,4000,0
14471574,44985,CON30HC,4000,4,4000,0
14347774,44939,CON30HC,4000,4,4000,0
14381728,44953,CON30HC,4000,4,4000,0
14456684,44981,CON30HC,4000,4,4000,0
14351696,44939,CON30HC,4000,4,4000,0
14368059,44946,CON30HC,4000,3,3000,1000
14408319,44965,CON30HC,4000,4,4000,0
14471575,44985,CON30HC,4000,4,4000,0
14520176,45007,CON30HC,4000,3,3000,1000
14374663,44950,CON30HC,4000,4,4000,0
14337947,44935,CON30HC,4000,4,4000,0
14425246,44966,CON30HC,4000,3,3000,1000
14346225,44938,CON30HC,4000,4,4000,0
14494802,44993,TC30,34000,31,31000,3000
14494802,44993,TC30,34000,,34000,0
14337949,44936,CON30HC,4000,4,4000,0
14330193,44930,CON30HC,4000,4,4000,0
14375731,44946,CON30HC,4000,3,3000,1000
14491271,44995,CON30HC,4000,4,4000,0
14437446,44973,CON30HC,4000,4,4000,0
14534136,45009,CON30HC,4000,4,4000,0
14340288,44936,CON30HC,4000,3,3000,1000
14479972,44991,CON30HC,4000,,4000,0
14479972,44991,CON30HC,4000,4,4000,0
14395665,44958,CON30HC,4000,3,3000,1000
14392746,44957,CON30HC,4000,4,4000,0
14365762,44945,CON30HC,4000,4,4000,0
14435035,44971,CON30HC,4000,4,4000,0
14477153,44988,CON30HC,4000,4,4000,0
14452634,44979,CON30HC,4000,4,4000,0
14383138,44951,CON30HC,4000,4,4000,0
14454387,44980,CON30HC,4000,4,4000,0
14508453,45001,CON30HC,4000,4,4000,0
14370702,44945,CON30,30000,31,31000,-1000
14395666,44958,CON30HC,4000,3,3000,1000
14454388,44979,CON30HC,4000,4,4000,0
14330958,44928,TC20,8000,4,4000,4000
14461342,44981,CON30,3000,4,4000,-1000
14365698,44943,TC20,8000,5,5000,3000
14529193,45006,TC30,6000,4,4000,2000
14327873,44929,TC30,34000,26,26000,8000
14508341,44999,TC30,36000,31,31000,5000
14502563,45006,TC20,5000,5,5000,0
14464569,44990,TC20,5000,5,5000,0
14375032,44965,TC20,5000,4,4000,1000
14463961,44985,TC30,38000,30,30000,8000
14509753,44999,TC30,32000,31,31000,1000
14509753,44999,TC30,32000,,32000,0
14507290,44998,TC20,23000,24,24000,-1000
14507290,44998,TC20,23000,,23000,0
14361339,44942,TRA,20000,20,20000,0
14469983,44984,TRA,14500,21,21000,-6500
14363205,44942,TRA,39000,36,36000,3000
14376220,44946,TRA,35000,30,30000,5000
14393038,44957,TC20,5000,5,5000,0
14418120,44967,TC20,5000,,5000,0
14437696,44977,TC20,5000,5,5000,0
14368338,44950,TC20,5000,4,4000,1000
14464525,44987,TC20,5000,5,5000,0
14475112,44992,TC20,5000,4,4000,1000
14507729,45001,TC20,5000,5,5000,0
14520952,45008,TC20,5000,5,5000,0
14437500,44977,TC20,5000,5,5000,0
14452209,44985,TC20,5000,3,3000,2000
14418187,44966,TC20,5000,5,5000,0
14496883,45002,TC20,5000,10,10000,-5000
14496882,45001,TC20,5000,5,5000,0
14525445,45005,CON40,6000,,6000,0
14525445,45005,CON40,6000,4,4000,2000
14480128,44987,CON20,2000,2,2000,0
14480129,44987,CON20,2000,2,2000,0
14458208,44986,CON20,27000,27,27000,0
14458216,44985,CON20,27000,28,28000,-1000
14458216,44985,CON20,27000,,27000,0
14458207,44985,CON20,27000,,27000,0
14458207,44985,CON20,27000,27,27000,0
14458214,44987,CON20,27000,27,27000,0
14458214,44987,CON20,27000,,27000,0
14458214,44987,CON20,27000,,27000,0
14458209,44987,CON20,27000,27,27000,0
14458217,44985,CON20,27000,,27000,0
14458217,44985,CON20,27000,28,28000,-1000
14458210,44984,CON20,27000,28,28000,-1000
14458210,44984,CON20,27000,,27000,0
14458213,44986,CON20,27000,27,27000,0
14458212,44987,CON20,27000,27,27000,0
14458215,44986,CON20,27000,27,27000,0
14458211,44984,CON20,27000,,27000,0
14458211,44984,CON20,27000,27,27000,0
14458206,44984,CON20,27000,28,28000,-1000
14458206,44984,CON20,27000,,27000,0
14333216,44930,TC20,29000,23,23000,6000
14322572,44928,TC20,31700,26,26000,5700
14454915,44979,TC20,24700,24,24000,700
14482879,44988,TC20,5000,4,4000,1000
14330311,44929,TC20,31580,31,31000,580
14348062,44942,TC20,31580,31,31000,580
14491206,44998,TC20,30000,30,30000,0
14434349,44974,TC20,30000,30,30000,0
14460944,44984,TC20,30000,28,28000,2000
14396741,44960,TC20,30000,30,30000,0
14330736,44935,TC20,31310,31,31000,310
14361535,44943,TC20,5000,5,5000,0
14384447,44952,TC20,5000,4,4000,1000
14404758,44965,TC20,30000,30,30000,0
14357745,44942,TC20,5000,5,5000,0
14326514,44930,TC20,5000,5,5000,0
14456667,44984,TC20,29000,,29000,0
14456667,44984,TC20,29000,24,24000,5000
14508333,44999,TC20,27000,24,24000,3000
14508333,44999,TC20,27000,,27000,0
14508333,44999,TC20,27000,25,25000,2000
14337422,44935,TC20,31000,31,31000,0
14396059,44956,TC20,29000,29,29000,0
14469672,44991,TC20,31000,30,30000,1000
14426422,44970,TC20,29000,23,23000,6000
14348359,44939,TC20,28000,28,28000,0
14362628,44946,TC20,31000,31,31000,0
14471437,44991,TC20,24000,24,24000,0
14506630,45000,TC20,34720,31,31000,3720
14382309,44953,TC20,25000,24,24000,1000
14326332,44930,TC20,31000,30,30000,1000
14326332,44930,TC20,31000,,31000,0
14469670,44988,TC20,30000,30,30000,0
14471804,44987,TC20,5000,5,5000,0
14471804,44987,TC20,5000,,5000,0
14490972,44998,TC20,5000,5,5000,0
14528482,45009,TC20,5000,5,5000,0
14490975,44999,TC23,5000,5,5000,0
14455041,44981,TC26,31000,31,31000,0
14483043,44994,TC26,5000,5,5000,0
14355790,44944,TC26,28000,28,28000,0
14408062,44966,TC20,32000,31,31000,1000
14477871,44992,TC26,31000,31,31000,0
14420676,44977,TC26,30000,30,30000,0
14398943,44959,TC26,31000,30,30000,1000
14404844,44963,TC26,5000,5,5000,0
14386216,44953,TC26,5000,5,5000,0
14471805,44988,TC26,5000,4,4000,1000
14490973,44995,TC26,5000,5,5000,0
14453990,44979,TC20,27320,28,28000,-680
14516851,45005,TC26,25000,25,25000,0
14400207,44959,TC26,28000,28,28000,0
14365105,44945,TC26,28000,28,28000,0
14477665,44991,TC20,30000,28,28000,2000
14477665,44991,TC20,30000,,30000,0
14502728,44995,TC20,32000,,32000,0
14502728,44995,TC20,32000,31,31000,1000
14406048,44960,TC26,26000,26,26000,0
14436433,44972,TC26,20000,20,20000,0
14382882,44956,TC20,31620,32,32000,-380
14351777,44939,TC26,32000,33,33000,-1000
14388923,44953,TC20,5000,5,5000,0
14435517,44971,TC20,26000,24,24000,2000
14442490,44974,TC20,5000,5,5000,0
14475786,44986,TC20,23920,24,24000,-80
14482583,44991,TC23,5000,5,5000,0
14515761,45001,TC23,5000,5,5000,0
14506399,44998,TC23,23920,23,23000,920
14525482,45006,TC20,26000,24,24000,2000
14330812,44929,TC20,5000,4,4000,1000
14327899,44928,TC20,8000,4,4000,4000
14330860,44930,TC20,5000,3,3000,2000
14330815,44929,TC20,5000,4,4000,1000
14327900,44928,TC20,8000,4,4000,4000
14330863,44930,TC20,5000,3,3000,2000
14364712,44943,TC20,27350,28,28000,-650
14514116,45000,TC23,30000,30,30000,0
14436089,44971,TC23,30000,,30000,0
14465026,44985,TC23,30000,30,30000,0
14375534,44949,TC23,30000,28,28000,2000
14414370,44980,TC23,30000,30,30000,0
14333217,44930,TC20,37000,32,32000,5000
14480097,44992,TC20,28982,29,29000,-18
14346274,44937,TC23,37000,31,31000,6000
14390343,44957,TC26,5000,5,5000,0
14440979,44977,TC26,5000,4,4000,1000
14475045,44987,TRA,7000,7,7000,0
14475052,44987,TRA,7000,7,7000,0
14532828,45007,TRA,35000,14,14000,21000
14332589,44929,TRA,39000,31,31000,8000
14352572,44938,TRA,27000,27,27000,0
14482665,44988,TRA,7000,7,7000,0
14506313,44998,TRA,8000,,8000,0
14506313,44998,TRA,8000,7,7000,1000
14470221,44984,TRA,7000,6,6000,1000
14470227,44985,TRA,7000,7,7000,0
14488380,44991,TRA,7000,,7000,0
14488380,44991,TRA,7000,7,7000,0
14485409,44990,TRA,7000,7,7000,0
14476077,44990,TRA,7000,,7000,0
14460058,44980,TRA,7000,7,7000,0
14427389,44970,TRA,14200,7,7000,7200
14453593,44978,TRA,14000,8,8000,6000
14476106,44990,TRA,7000,7,7000,0
14460102,44980,TRA,7000,7,7000,0
14453596,44979,TRA,14000,,14000,0
14502659,44997,TRA,7000,,7000,0
14515751,45001,TRA,7000,7,7000,0
14485407,44990,TRA,7000,7,7000,0
14427350,44970,TRA,14200,7,7000,7200
14460064,44980,TRA,7000,7,7000,0
14456730,44979,TRA,14000,,14000,0
14476086,44990,TRA,7000,,7000,0
14476088,44990,TRA,7000,7,7000,0
14436184,44972,TRA,14200,7,7000,7200
14467148,44983,TRA,7000,7,7000,0
14467151,44983,TRA,7000,6,6000,1000
14506314,44998,TRA,8000,7,7000,1000
14506314,44998,TRA,8000,,8000,0
14456736,44979,TRA,14000,8,8000,6000
14476083,44988,TRA,7000,7,7000,0
14427390,44971,TRA,14200,7,7000,7200
14469739,44984,TRA,8000,7,7000,1000
14475658,44986,TRA,7000,7,7000,0
14506300,44998,TRA,8000,7,7000,1000
14506300,44998,TRA,8000,,8000,0
14515749,45001,TRA,7000,7,7000,0
14502672,44997,TRA,7000,,7000,0
14472237,44986,TRA,7000,7,7000,0
14467150,44984,TRA,7000,6,6000,1000
14510784,45001,TRA,7000,7,7000,0
14478127,44987,TRA,7000,7,7000,0
14493806,44994,TRA,11000,,11000,0
14493806,44994,TRA,11000,,11000,0
14495261,44994,TRA,7000,,7000,0
14495261,44994,TRA,7000,6,6000,1000
14478128,44987,TRA,7000,7,7000,0
14470247,44985,TRA,7000,7,7000,0
14528801,45008,TRA,7000,7,7000,0
14472233,44985,TRA,7000,7,7000,0
14491348,44993,TRA,7000,,7000,0
14491348,44993,TRA,7000,,7000,0
14491348,44993,TRA,7000,,7000,0
14491348,44993,TRA,7000,,7000,0
14491348,44993,TRA,7000,7,7000,0
14478132,44987,TRA,7000,7,7000,0
14472231,44985,TRA,7000,6,6000,1000
14502678,44997,TRA,7000,9,9000,-2000
14520554,45002,TRA,7000,,7000,0
14520554,45002,TRA,7000,7,7000,0
14469763,44984,TRA,7000,7,7000,0
14476070,44988,TRA,7000,7,7000,0
14453592,44979,TRA,14000,8,8000,6000
14476071,44990,TRA,7000,,7000,0
14457791,44979,TRA,14000,,14000,0
14460039,44980,TRA,7000,7,7000,0
14485411,44990,TRA,7000,7,7000,0
14460065,44980,TRA,7000,7,7000,0
14453598,44978,TRA,14000,,14000,0
14453598,44978,TRA,14000,8,8000,6000
14439642,44973,TRA,14200,7,7000,7200
14456734,44979,TRA,14000,7,7000,7000
14456734,44979,TRA,14000,8,8000,6000
14476073,44990,TRA,7000,,7000,0
14485408,44990,TRA,7000,7,7000,0
14485487,44990,TRA,7000,,7000,0
14495860,44994,TRA,7000,,7000,0
14495860,44994,TRA,7000,,7000,0
14510815,45001,TRA,7000,7,7000,0
14454985,44979,TRA,14000,7,7000,7000
14439641,44972,TRA,14200,10,10000,4200
14476076,44990,TRA,7000,,7000,0
14456815,44979,TRA,14000,7,7000,7000
14485403,44990,TRA,7000,7,7000,0
14487804,44991,TRA,7000,,7000,0
14487804,44991,TRA,7000,7,7000,0
14456774,44979,TRA,14000,13,13000,1000
14476081,44988,TRA,7000,7,7000,0
14436178,44972,TRA,14200,10,10000,4200
14436158,44972,TRA,14200,7,7000,7200
14476079,44990,TRA,7000,,7000,0
14456732,44979,TRA,14000,15,15000,-1000
14485405,44990,TRA,7000,7,7000,0
14506298,44998,TRA,8000,,8000,0
14506298,44998,TRA,8000,7,7000,1000
14472234,44986,TRA,7000,,7000,0
14472234,44986,TRA,7000,7,7000,0
14456727,44979,TRA,14000,,14000,0
14460100,44980,TRA,7000,7,7000,0
14427392,44971,TRA,14200,7,7000,7200
14510783,45001,TRA,7000,7,7000,0
14485410,44990,TRA,7000,7,7000,0
14436186,44973,TRA,14200,8,8000,6200
14476087,44990,TRA,7000,,7000,0
14475660,44986,TRA,7000,8,8000,-1000
14510813,45001,TRA,7000,7,7000,0
14506319,44998,TRA,8000,7,7000,1000
14506319,44998,TRA,8000,,8000,0
14478142,44987,TRA,7000,7,7000,0
14467149,44983,TRA,7000,7,7000,0
14506315,44998,TRA,8000,,8000,0
14506315,44998,TRA,8000,7,7000,1000
14379979,44949,TRA,15000,7,7000,8000
14475050,44987,TRA,7000,6,6000,1000
14492788,44993,TRA,12000,,12000,0
14492788,44993,TRA,12000,11,11000,1000
14337928,44930,TRA,7000,7,7000,0
14436335,44971,TRA,36000,27,27000,9000
14472467,44986,TRA,31000,,31000,0
14481446,44988,TRA,31000,27,27000,4000
14479030,44987,TRA,7000,,7000,0
14479030,44987,TRA,7000,5,5000,2000
14399141,44957,TRA,27000,18,18000,9000
14418978,44965,TRA,15000,12,12000,3000
14364718,44943,TRA,15000,7,7000,8000
14481605,44988,TRA,25000,21,21000,4000
14353444,44938,TRA,15000,7,7000,8000
14353433,44938,TRA,15000,8,8000,7000
14364724,44943,TRA,15000,7,7000,8000
14330634,44928,TRA,15000,8,8000,7000
14371277,44945,TRA,15000,6,6000,9000
14435499,44971,TRA,27500,13,13000,14500
14516916,45001,TRA,8000,7,7000,1000
14353958,44938,CON40,8000,5,5000,3000
14370098,44949,TC20,5000,5,5000,0
14325554,44928,TC20,5000,5,5000,0
14408131,44964,TC20,5000,5,5000,0
14479424,44991,TC20,5000,5,5000,0
14442418,44977,TC20,5000,5,5000,0
14396167,44959,TC20,30000,30,30000,0
14339290,44936,TC20,24000,24,24000,0
14405454,44963,CON40,17000,17,17000,0
14502506,45001,CON20,7000,7,7000,0
14443645,44978,CON45,4500,5,5000,-500
14470080,44986,CON45,4500,4,4000,500
14381012,44949,TC30,6000,6,6000,0
14345969,44939,TC30,6000,6,6000,0
14434276,44980,TC30,6000,3,3000,3000
14434277,44977,TC30,6000,5,5000,1000
14433021,44973,TC30,6000,6,6000,0
14338071,44935,TC40,35000,34,34000,1000
14502505,45001,CON20,7000,7,7000,0
14452425,44978,CON40,35000,30,30000,5000
14473427,44994,CON40,30000,30,30000,0
14416586,44972,CON40,30000,30,30000,0
14416586,44972,CON40,30000,,30000,0
14473428,44992,CON40,30000,30,30000,0
14440055,44974,CON40,35000,29,29000,6000
14331783,44931,CON40,30000,30,30000,0
14331129,44929,CON40,33000,33,33000,0
14405288,44967,CON40,30000,30,30000,0
14438555,44972,CON40,35000,30,30000,5000
14453815,44986,CON40,30000,30,30000,0
14400349,44963,CON40,30000,29,29000,1000
14405287,44966,CON40,30000,30,30000,0
14488114,45001,CON40,30000,30,30000,0
14336291,44936,CON40,30000,29,29000,1000
14453814,44986,CON40,30000,30,30000,0
14435427,44971,CON40,32000,30,30000,2000
14347325,44942,CON40,30000,30,30000,0
14490297,45001,CON40,30000,28,28000,2000
14347275,44944,CON40,30000,30,30000,0
14331784,44936,CON40,30000,30,30000,0
14340136,44939,CON40,30000,30,30000,0
14506241,44998,TC23,5000,5,5000,0
14455790,44979,TC23,5000,5,5000,0
14362198,44943,TC26,5000,5,5000,0
14396171,44958,TC26,5000,5,5000,0
14521023,45005,TC23,5000,5,5000,0
14392458,44956,TC20,23750,24,24000,-250
14369948,44945,TC20,28760,21,21000,7760
14424485,44970,TC20,26760,26,26000,760
14506261,44998,TC20,31000,,31000,0
14506261,44998,TC20,31000,30,30000,1000
14330677,44930,TC20,25100,25,25000,100
14397378,44956,TC20,34000,28,28000,6000
14364782,44946,TC20,27520,28,28000,-480
14347484,44936,TC20,27000,21,21000,6000
14508477,45000,TC20,30670,30,30000,670
14508477,45000,TC20,30670,,30670,0
14469909,44987,CON20,24700,30,30000,-5300
14503093,45000,TC20,28170,28,28000,170
14441034,44974,TC20,30170,30,30000,170
14396097,44959,TC20,28170,28,28000,170
14330727,44937,TC20,24170,24,24000,170
14339181,44937,TC20,24170,24,24000,170
14364783,44946,TC20,24170,24,24000,170
14469407,44988,TC20,24170,25,25000,-830
14471439,44991,TC20,24000,31,31000,-7000
14471439,44991,TC20,24000,,24000,0
14471439,44991,TC20,24000,32,32000,-8000
14477032,44991,TC26,35600,35,35000,600
14442502,44980,TC20,26440,26,26000,440
14482707,44988,TC20,5000,4,4000,1000
14483181,44988,TC20,5000,4,4000,1000
14483178,44988,TC20,5000,4,4000,1000
14482708,44988,TC20,5000,4,4000,1000
14482708,44988,TC20,5000,,5000,0
14482870,44988,TC20,5000,4,4000,1000
14482870,44988,TC20,5000,,5000,0
14397311,44956,TRA,35000,11,11000,24000
14514782,45000,TRA,32000,18,18000,14000
14408905,44967,TC40,30100,30,30000,100
14402285,44959,TC40,30100,30,30000,100
14479976,44995,TC40,7000,4,4000,3000
14444571,44981,TC40,31100,32,32000,-900
14419458,44979,TC40,7000,6,6000,1000
14383593,44957,TC40,7000,3,3000,4000
14345506,44937,TC40,7000,3,3000,4000
14349229,44944,CON40,4000,4,4000,0
14392608,44965,CON40,4000,3,3000,1000
14452202,44987,CON40,4000,4,4000,0
14506430,44999,CON40,4000,4,4000,0
14506430,44999,CON40,4000,,4000,0
14528565,45009,TC40,30100,,30100,0
14460182,44988,TC40,31100,31,31000,100
14466037,44993,TC40,7000,7,7000,0
14402756,44973,TC40,7000,4,4000,3000
14367965,44951,TC40,7000,7,7000,0
14526572,45008,TC40,7000,7,7000,0
14337604,44931,TC40,30100,29,29000,1100
14380601,44953,TC40,30100,30,30000,100
14441039,44974,TC40,30100,30,30000,100
14513577,45002,TC40,28900,28,28000,900
14350491,44942,TC40,31100,31,31000,100
14340760,44935,TC40,29600,30,30000,-400
14513574,45001,TC40,29140,30,30000,-860
14520246,45002,KTA,25000,17,17000,8000
14520246,45002,KTA,25000,,25000,0
14507149,44998,KTA,29000,15,15000,14000
14536082,45008,KTA,25000,18,18000,7000
14536082,45008,KTA,25000,,25000,0
14519302,45002,TC20,29000,29,29000,0
14470017,44985,TC20,29000,29,29000,0
14351643,44937,TC20,34000,28,28000,6000
14414776,44964,TC20,29000,28,28000,1000
14414383,44973,TC20,28000,28,28000,0
14348100,44946,TC20,28000,28,28000,0
14273065,44931,TC20,28000,28,28000,0
14455572,44986,TC20,28000,28,28000,0
14490302,45001,TC20,28000,28,28000,0
14492377,44994,TC20,19000,19,19000,0
14510188,45005,TC20,5000,5,5000,0
14442419,44977,TC20,5000,,5000,0
14442419,44977,TC20,5000,5,5000,0
14442419,44977,TC20,5000,,5000,0
14340732,44935,TC20,23790,20,20000,3790
14379660,44956,TC20,5000,5,5000,0
14405860,44959,TC20,29000,24,24000,5000
14362740,44946,TC20,5000,5,5000,0
14435712,44974,TC20,5000,5,5000,0
14478568,44987,TC20,24000,24,24000,0
14478568,44987,TC20,24000,24,24000,0
14478568,44987,TC20,24000,24,24000,0
14506714,45005,TC20,5000,5,5000,0
14502056,44995,TC20,26000,23,23000,3000
14502056,44995,TC20,26000,,26000,0
14435443,44972,TC20,24000,24,24000,0
14451429,44979,TC20,5000,4,4000,1000
14322581,44929,TC20,29000,23,23000,6000
14396435,44963,TC20,5000,5,5000,0
14386648,44960,TC20,5000,,5000,0
14386648,44960,TC20,5000,,5000,0
14386648,44960,TC20,5000,,5000,0
14386648,44960,TC20,5000,,5000,0
14375385,44949,TC20,5000,5,5000,0
14446246,44977,TC20,5000,5,5000,0
14479416,44992,TC20,5000,5,5000,0
14453823,44984,TC20,30220,31,31000,-780
14399403,44958,TC20,33000,30,30000,3000
14399403,44958,TC20,33000,,33000,0
14408135,44964,TC20,5000,5,5000,0
14330556,44931,TC20,5000,4,4000,1000
14369656,44945,TC20,23870,19,19000,4870
14450502,44977,TC20,18870,18,18000,870
14488205,44995,TC20,5000,5,5000,0
14526111,45005,TC20,18830,,18830,0
14526111,45005,TC20,18830,19,19000,-170
14490008,44999,TC20,24000,24,24000,0
14364549,44949,TC20,24000,25,25000,-1000
14401620,44965,TC20,24000,24,24000,0
14375710,44953,TC20,29000,29,29000,0
14298252,44929,TC20,30000,30,30000,0
14439725,44979,TC20,24000,24,24000,0
14441712,44973,TC20,24000,23,23000,1000
14463064,44981,TC20,35000,31,31000,4000
14488980,44991,TC20,9000,,9000,0
14488980,44991,TC20,9000,30,30000,-21000
14460830,44984,TC20,5000,4,4000,1000
14328705,44930,TC20,5000,5,5000,0
14351551,44942,TC20,5000,5,5000,0
14386650,44963,TC20,5000,4,4000,1000
14424457,44970,TC20,5000,5,5000,0
14424458,44970,TC20,5000,4,4000,1000
14386649,44963,TC20,5000,5,5000,0
14351553,44942,TC20,5000,4,4000,1000
14446245,44978,TC20,5000,4,4000,1000
14481772,44991,TC20,5000,5,5000,0
14348098,44945,TC23,30000,,30000,0
14533565,45009,TC20,5000,4,4000,1000
14379753,44950,TC20,5000,4,4000,1000
14379935,44950,TC20,5000,4,4000,1000
14482452,44991,TC23,5000,4,4000,1000
14533529,45009,TC20,5000,5,5000,0
14351506,44938,TC20,5000,4,4000,1000
14533531,45009,TC20,5000,4,4000,1000
14483335,44992,CON30,4000,4,4000,0
14452635,44980,CON30,4000,4,4000,0
14362830,44942,CON30,35000,30,30000,5000
14362830,44942,CON30,35000,,35000,0
14365690,44952,CON30,4000,4,4000,0
14375889,44946,CON30,11700,28,28000,-16300
14495164,44993,CON30,3000,31,31000,-28000
14533799,45008,CON30,32000,,32000,0
14397765,44958,CON30,4000,4,4000,0
14372685,44951,CON30,4000,4,4000,0
14364240,44943,CON30,35000,32,32000,3000
14491794,44992,CON30,29000,,29000,0
14491794,44992,CON30,29000,32,32000,-3000
14442371,44973,CON30,33000,32,32000,1000
14469000,44985,CON30,4000,5,5000,-1000
14361464,44942,CON30,35000,31,31000,4000
14375157,44946,CON30,4000,4,4000,0
14440218,44979,CON30,4000,4,4000,0
14442376,44973,CON30,33000,31,31000,2000
14495166,44993,CON30,31000,31,31000,0
14495166,44993,CON30,31000,,31000,0
14357337,44939,CON30,33000,,33000,0
14357337,44939,CON30,33000,32,32000,1000
14533725,45008,CON30,30000,,30000,0
14537335,45009,CON30,31000,,31000,0
14537335,45009,CON30,31000,,31000,0
14362835,44942,CON30,33000,31,31000,2000
14491788,44992,CON30,29500,,29500,0
14491788,44992,CON30,29500,31,31000,-1500
14525671,45009,CON30,4000,4,4000,0
14512247,45009,CON30,27500,27,27000,500
14326091,44929,CON30,4000,4,4000,0
14389468,44959,CON30,4000,4,4000,0
14345869,44935,CON30,38000,32,32000,6000
14495169,44993,CON30,31000,,31000,0
14495169,44993,CON30,31000,32,32000,-1000
14344605,44937,CON30,4000,4,4000,0
14409102,44965,CON30,4000,4,4000,0
14327125,44929,CON30,4000,3,3000,1000
14353388,44938,CON30,36000,32,32000,4000
14398930,44958,CON30,4000,4,4000,0
14396814,44956,CON30,33000,32,32000,1000
14396814,44956,CON30,33000,,33000,0
14469995,44984,CON30,28000,28,28000,0
14471500,44988,CON30,4000,4,4000,0
14441168,44980,CON30,4000,4,4000,0
14471651,44991,CON30,4000,4,4000,0
14392846,44956,CON30,4000,4,4000,0
14354612,44938,CON30,3000,31,31000,-28000
14396779,44956,CON30,33000,,33000,0
14396779,44956,CON30,33000,32,32000,1000
14533795,45008,CON30,32000,,32000,0
14471604,44985,TC30,32000,32,32000,0
14453790,44979,CON30,4000,4,4000,0
14399474,44957,TC30,38000,,38000,0
14399474,44957,TC30,38000,31,31000,7000
14373056,44951,CON30,4000,4,4000,0
14496396,45001,CON30,4000,3,3000,1000
14488987,44992,CON20,30000,,30000,0
14488987,44992,CON20,30000,30,30000,0
14510625,45008,CON30,27500,28,28000,-500
14380109,44949,CON30,33000,32,32000,1000
14336588,44930,CON30,36000,32,32000,4000
14336588,44930,CON30,36000,,36000,0
14330603,44935,CON30,27500,28,28000,-500
14496870,45005,CON30,4000,4,4000,0
14488985,44992,TC30,34000,32,32000,2000
14488985,44992,TC30,34000,,34000,0
14513714,45008,CON40,30000,30,30000,0
14433104,44974,TC40,32000,30,30000,2000
14487981,45000,CON40,30000,30,30000,0
14436926,44972,CON40,7000,4,4000,3000
14471406,44986,TRA,22000,17,17000,5000
14332572,44929,TRA,15000,7,7000,8000
14337929,44930,TRA,7000,6,6000,1000
14337930,44930,TRA,7000,7,7000,0
14502504,45001,CON20,7000,7,7000,0
14536893,45009,TC20,20390,24,24000,-3610
14470713,44985,TC20,25850,25,25000,850
14461008,44985,TC20,30550,31,31000,-450
14364784,44945,TC20,30550,31,31000,-450
14365182,44946,TC20,30550,31,31000,-450
14372975,44950,CON30,30550,31,31000,-450
14364788,44945,TC20,36530,35,35000,1530
14364793,44946,TC20,30490,31,31000,-510
14465291,44985,TC20,36590,31,31000,5590
14330743,44936,TC20,30740,30,30000,740
14408295,44964,TC20,30550,30,30000,550
14426470,44970,TC25,5000,5,5000,0
14477036,44988,TC20,24530,25,25000,-470
14502137,44999,TC26,31560,30,30000,1560
14386265,44951,TC20,35000,,35000,0
14386265,44951,TC20,35000,28,28000,7000
14508490,45002,TC20,28530,29,29000,-470
14508487,45002,TC20,29530,29,29000,530
14457644,44981,TC26,31000,32,32000,-1000
14434265,44977,TC20,30530,30,30000,530
14331640,44929,TRA,15000,7,7000,8000
14331713,44929,TRA,7000,8,8000,-1000
14331718,44929,TRA,7000,7,7000,0
14336325,44930,TRA,15000,6,6000,9000
14331719,44930,TRA,7000,8,8000,-1000
14337925,44930,TRA,7000,7,7000,0
14331685,44929,TRA,15000,7,7000,8000
14337605,44930,TRA,15000,7,7000,8000
14337932,44930,TRA,7000,7,7000,0
14350658,44943,CON30,29990,30,30000,-10
14461158,45001,CON30,4000,4,4000,0
14513145,45000,CON30,4000,4,4000,0
14470013,44984,CON30,4000,4,4000,0
14496916,44994,CON30,4000,3,3000,1000
14464556,44999,CON30,4000,3,3000,1000
14506365,44999,CON30,4000,3,3000,1000
14413783,44967,CON30,4000,4,4000,0
14436406,44974,CON30,4000,4,4000,0
14436406,44974,CON30,4000,,4000,0
14479975,44993,CON30,4000,4,4000,0
14469326,44988,CON30,4000,4,4000,0
14416817,44970,CON30,29990,,29990,0
14481576,44993,CON30,4000,4,4000,0
14350091,44942,CON30,4000,4,4000,0
14469858,44985,CON30,4000,4,4000,0
14438749,44978,CON30,4000,4,4000,0
14515722,45005,CON30,4000,4,4000,0
14507830,44999,CON30,29990,29,29000,990
14454167,44978,CON30,4000,4,4000,0
14322944,44929,CON30,3000,3,3000,0
14414101,44967,CON30,4000,3,3000,1000
14356789,44942,CON30,4000,4,4000,0
14350090,44942,CON30,4000,4,4000,0
14464557,44998,CON30,4000,3,3000,1000
14515718,45002,CON30,4000,4,4000,0
14469325,44991,CON30,4000,4,4000,0
14521212,45005,CON30,4000,4,4000,0
14417344,44964,CON30,4000,4,4000,0
14526274,45006,CON30,4000,4,4000,0
14501963,45007,CON30,29900,29,29000,900
14396926,44964,CON30,29990,28,28000,1990
14508435,44999,CON30,4000,4,4000,0
14511372,44999,CON30,4000,4,4000,0
14438692,44978,CON30,4000,4,4000,0
14382421,44952,CON30,29990,30,30000,-10
14405151,44964,CON30,4000,4,4000,0
14452631,44980,CON30,4000,4,4000,0
14379720,44951,CON30,4000,4,4000,0
14512672,45002,CON30,4000,4,4000,0
14350581,44944,CON30,4000,4,4000,0
14426117,44973,CON30,4000,4,4000,0
14413213,44967,CON30,4000,4,4000,0
14479691,44988,CON30,29990,30,30000,-10
14355290,44944,CON30,4000,4,4000,0
14472088,44991,CON30,4000,4,4000,0
14438748,44979,CON30,4000,4,4000,0
14529391,45008,CON30,4000,4,4000,0
14355234,44944,CON30,4000,4,4000,0
14501446,44995,CON30,4000,4,4000,0
14479690,44988,CON30,29990,30,30000,-10
14469862,44985,CON30,4000,3,3000,1000
14363020,44945,CON30,4000,4,4000,0
14426118,44973,CON30,4000,4,4000,0
14386399,44957,CON30,29990,29,29000,990
14336923,44937,CON30,29990,30,30000,-10
14482385,44993,CON30,29990,30,30000,-10
14408663,44963,CON30,29990,31,31000,-1010
14327893,44930,CON30,3000,3,3000,0
14327893,44930,CON30,3000,,3000,0
14514123,45002,TC30,30000,29,29000,1000
14433445,44973,CON30,4000,4,4000,0
14426705,44970,CON30,4000,4,4000,0
14324587,44936,CON30,29990,30,30000,-10
14469526,44984,CON30,4000,,4000,0
14469526,44984,CON30,4000,4,4000,0
14446188,44977,CON30,29900,31,31000,-1100
14413786,44970,CON30,4000,4,4000,0
14526273,45006,CON30,4000,4,4000,0
14481583,44992,CON30,4000,4,4000,0
14347603,44939,CON30,29990,29,29000,990
14461157,44999,CON30,4000,4,4000,0
14413215,44965,CON30,4000,5,5000,-1000
14452630,44979,CON30,29990,30,30000,-10
14454170,44981,CON30,4000,4,4000,0
14324586,44929,CON30,29990,30,30000,-10
14389136,44956,CON30,29990,30,30000,-10
14426147,44971,CON30,4000,3,3000,1000
14482337,44991,CON30,29990,30,30000,-10
14515714,45001,CON30,4000,4,4000,0
14450796,44980,CON30,4000,3,3000,1000
14526272,45006,CON30,4000,4,4000,0
14464554,44986,CON30,29990,30,30000,-10
14472087,44987,CON30,4000,4,4000,0
14379750,44953,CON30,4000,4,4000,0
14468988,44986,CON30,4000,4,4000,0
14417303,44973,CON30,29900,30,30000,-100
14422425,44970,CON30,4000,3,3000,1000
14469857,44985,CON30,4000,4,4000,0
14396086,44960,CON30,4000,3,3000,1000
14497023,44995,CON30,4000,4,4000,0
14481582,44993,CON30,4000,3,3000,1000
14326054,44929,CON30,3000,3,3000,0
14350487,44951,CON30,4000,4,4000,0
14506364,44998,CON30,4000,3,3000,1000
14414100,44971,CON30,4000,4,4000,0
14400149,44957,TC20,29130,24,24000,5130
14432662,44971,TC20,20260,23,23000,-2740
14450487,44977,TC20,20360,24,24000,-3640
14399451,44957,TC20,29220,24,24000,5220
14485396,44991,TC20,20510,25,25000,-4490
14465148,44981,TC20,20500,24,24000,-3500
14463603,44981,TC20,24000,23,23000,1000
14472475,44986,TC20,31000,31,31000,0
14373040,44946,SWAP20,26660,24,24000,2660
14369944,44945,TC20,28600,22,22000,6600
14413204,44963,TC20,34000,28,28000,6000
14454916,44979,TC20,24600,25,25000,-400
14327856,44928,TC20,33000,29,29000,4000
14352606,44942,TC20,31620,25,25000,6620
14526877,45006,TC20,23620,,23620,0
14526877,45006,TC20,23620,23,23000,620
14471400,44985,TC20,32000,31,31000,1000
14530172,45007,TC20,25000,23,23000,2000
14396623,44958,TC20,34000,29,29000,5000
14357670,44942,TC20,34000,27,27000,7000
14404606,44960,TC20,34000,,34000,0
14404606,44960,TC20,34000,29,29000,5000
14530176,45007,TC20,25000,,25000,0
14530176,45007,TC20,25000,,25000,0
14533431,45008,TC20,21710,23,23000,-1290
14322573,44928,TC20,30220,26,26000,4220
14454918,44979,TC20,24820,24,24000,820
14485397,44991,TC20,23820,,23820,0
14485397,44991,TC20,23820,23,23000,820
14470014,44985,TC20,25820,25,25000,820
14450485,44977,TC20,26190,26,26000,190
14419073,44965,TC20,5000,4,4000,1000
14485392,44991,TC20,23640,24,24000,-360
14426418,44967,TC20,34000,28,28000,6000
14387932,44952,TC20,29110,24,24000,5110
14387936,44952,TC20,31130,24,24000,7130
14369942,44945,TC20,28600,22,22000,6600
14485398,44991,TC20,23600,23,23000,600
14485398,44991,TC20,23600,,23600,0
14485398,44991,TC20,23600,24,24000,-400
14459973,44980,TC20,23600,23,23000,600
14413193,44963,TC20,34000,27,27000,7000
14322578,44928,TC20,31600,26,26000,5600
14526879,45006,TC20,23600,22,22000,1600
14526879,45006,TC20,23600,,23600,0
14418569,44965,TC20,23600,23,23000,600
14494699,44994,TC20,33000,29,29000,4000
14482443,44988,TC20,31000,30,30000,1000
14345834,44938,TC20,28000,28,28000,0
14374709,44946,TC20,28600,24,24000,4600
14485399,44992,TC20,23600,23,23000,600
14468612,44984,TC20,33000,31,31000,2000
14327284,44928,TC20,28000,28,28000,0
14367389,44949,TC20,34000,29,29000,5000
14367342,44946,TC20,33000,,33000,0
14367342,44946,TC20,33000,,33000,0
14367342,44946,TC20,33000,,33000,0
14367342,44946,TC20,33000,28,28000,5000
14419901,44965,TC20,24000,23,23000,1000
14419821,44965,TC20,24000,23,23000,1000
14419828,44965,TC20,24000,23,23000,1000
14419830,44965,TC20,24000,24,24000,0
14419832,44966,TC20,24000,23,23000,1000
14519286,45002,TC20,27300,27,27000,300
14425690,44967,TC20,27800,27,27000,800
14509774,44999,TC20,32000,32,32000,0
14509774,44999,TC20,32000,,32000,0
14432622,44971,TC20,29300,29,29000,300
14446414,44981,TC26,30000,30,30000,0
14399335,44960,TC26,28000,28,28000,0
14389127,44956,CON30,31360,31,31000,360
14496905,44999,CON30,31360,31,31000,360
14496904,44998,CON30,28320,31,31000,-2680
14425089,44971,CON30,31410,31,31000,410
14389132,44958,CON30,31400,31,31000,400
14496908,45001,CON30,31540,30,30000,1540
14524246,45007,CON30,30260,31,31000,-740
14419826,44967,CON30,31020,31,31000,20
14389133,44959,CON30,30420,30,30000,420
14510464,44999,KTA,35000,16,16000,19000
14491816,44992,KTA,35000,22,22000,13000
14475783,44986,KTA,39000,15,15000,24000
14524475,45005,KTA,35000,20,20000,15000
14357954,44942,TC25,5000,8,8000,-3000
14424876,44967,TC25,5000,5,5000,0
14475666,44987,TC25,25925,27,27000,-1075
14345170,44935,CON20,4000,3,3000,1000
14510791,45000,TC23,32000,32,32000,0
14510072,45001,TC20,5000,4,4000,1000
14510072,45001,TC20,5000,4,4000,1000
14527754,45008,TC20,5000,4,4000,1000
14456676,44984,TC20,28000,23,23000,5000
14432616,44970,TC20,27000,26,26000,1000
14502046,44999,TC20,25880,26,26000,-120
14419072,44965,TC20,5000,4,4000,1000
14368401,44946,TC23,5000,5,5000,0
14367381,44950,TC20,34000,30,30000,4000
14340246,44935,TC20,29300,29,29000,300
14445953,44978,TC20,28000,28,28000,0
14446411,44981,TC20,28000,28,28000,0
14345860,44938,TC20,28000,28,28000,0
14473069,44987,TC20,28500,28,28000,500
14502770,44999,CON30,4000,4,4000,0
14357662,44943,TC20,25000,24,24000,1000
14404759,44965,TC26,28000,28,28000,0
14397345,44963,TC25,30000,30,30000,0
14455718,44981,TC26,28000,28,28000,0
14384541,44952,TC20,31500,26,26000,5500
14422154,44966,TC20,24000,24,24000,0
14330809,44929,TC20,5000,3,3000,2000
14363116,44944,TC20,5000,5,5000,0
14437849,44971,FLA40,6000,5,5000,1000
14440224,44972,FLA20,2000,5,5000,-3000
14437931,44971,FLA40,6000,5,5000,1000
14362872,44942,CON40,8000,4,4000,4000
14472481,44986,TC20,5000,4,4000,1000
14464963,44981,TC20,25000,24,24000,1000
14330459,44935,TC20,30000,30,30000,0
14330810,44929,TC20,5000,3,3000,2000
14330449,44931,TC20,27570,28,28000,-430
14344532,44936,TC26,28000,28,28000,0
14421483,44970,TC26,32000,31,31000,1000
14535231,45009,TC20,30940,30,30000,940
14535231,45009,TC20,30940,,30940,0
14387340,44953,TC26,28000,28,28000,0
14526667,45007,TC20,27200,28,28000,-800
14397352,44958,TC26,28000,28,28000,0
14508321,44999,TC20,5000,5,5000,0
14419943,44972,TC20,31200,31,31000,200
14521064,45005,TC26,32000,32,32000,0
14372903,44949,TC26,32000,32,32000,0
14506400,44998,TC20,31000,,31000,0
14506400,44998,TC20,31000,30,30000,1000
14372904,44949,TC26,28000,28,28000,0
14345309,44949,CON40,18800,18,18000,800
14442326,44987,CON30,4000,4,4000,0
14445479,44978,TC20,33000,30,30000,3000
14508353,44999,TC20,31000,29,29000,2000
14434179,44973,TC20,25000,24,24000,1000
14476909,44993,TC20,28000,28,28000,0
14357685,44943,TC20,29000,24,24000,5000
14402860,44966,TC20,5000,5,5000,0
14367344,44949,TC20,29000,24,24000,5000
14440150,44978,TC20,31000,32,32000,-1000
14527808,45009,TC20,24000,24,24000,0
14367443,44950,TC20,5000,5,5000,0
14367442,44946,TC20,5000,4,4000,1000
14400464,44959,TC20,5000,4,4000,1000
14416569,44973,TC20,5000,5,5000,0
14365371,44946,TC20,30000,30,30000,0
14510221,45002,TC20,31000,30,30000,1000
14528416,45009,TC20,32640,32,32000,640
14327433,44930,TC20,23730,24,24000,-270
14493624,44995,TC20,29630,30,30000,-370
14372735,44953,TC20,33130,33,33000,130
14419790,44967,TC20,27710,30,30000,-2290
14469901,44984,TC20,25000,25,25000,0
14502470,44998,TC20,27930,28,28000,-70
14442702,44978,TC20,9260,9,9000,260
14532326,45009,TC20,20440,20,20000,440
14294257,44935,TC20,5000,5,5000,0
14294257,44935,TC20,5000,5,5000,0
14294257,44935,TC20,5000,,5000,0
14337258,44935,TC20,5000,5,5000,0
14337258,44935,TC20,5000,,5000,0
14427280,44972,TC20,5000,4,4000,1000
14403194,44959,TC20,5000,5,5000,0
14385851,44953,TC20,34000,32,32000,2000
14327455,44931,TC20,27820,28,28000,-180
14506846,44999,TC20,25210,25,25000,210
14506081,44998,TC20,32000,,32000,0
14506081,44998,TC20,32000,32,32000,0
14357580,44939,TRA,38000,,38000,0
14357580,44939,TRA,38000,25,25000,13000
14354703,44938,TRA,38000,,38000,0
14354703,44938,TRA,38000,,38000,0
14404601,44959,TRA,31000,34,34000,-3000
14404601,44959,TRA,31000,,31000,0
14465555,44984,TRA,35000,,35000,0
14465555,44984,TRA,35000,,35000,0
14465555,44984,TRA,35000,32,32000,3000
14352528,44937,TRA,38000,27,27000,11000
14477628,44987,TRA,31000,30,30000,1000
14502267,44995,TRA,31000,,31000,0
14502267,44995,TRA,31000,,31000,0
14502267,44995,TRA,31000,25,25000,6000
14496547,44994,TRA,32000,,32000,0
14496547,44994,TRA,32000,36,36000,-4000
14355088,44939,TRA,42000,34,34000,8000
14337390,44930,TRA,36000,,36000,0
14337390,44930,TRA,36000,21,21000,15000
14349139,44936,TRA,35000,35,35000,0
14353114,44938,TRA,45000,26,26000,19000
14337512,44930,PTRA,35000,,35000,0
14337512,44930,PTRA,35000,,35000,0
14337512,44930,PTRA,35000,7,7000,28000
14337512,44930,PTRA,35000,28,28000,7000
14407747,44960,TRA,42000,35,35000,7000
14347691,44936,TRA,33000,26,26000,7000
14373416,44945,TRA,35000,27,27000,8000
14373416,44945,TRA,35000,,35000,0
14373416,44945,TRA,35000,,35000,0
14373416,44945,TRA,35000,,35000,0
14496378,44994,TRA,31000,,31000,0
14496378,44994,TRA,31000,35,35000,-4000
14470846,44984,TRA,35000,34,34000,1000
14404553,44959,TRA,32000,,32000,0
14404553,44959,TRA,32000,,32000,0
14404553,44959,TRA,32000,,32000,0
14404553,44959,TRA,32000,34,34000,-2000
14492932,44993,TRA,35000,,35000,0
14492932,44993,TRA,35000,27,27000,8000
14355073,44938,TRA,35000,,35000,0
14362592,44943,TRA,35000,27,27000,8000
14503124,44995,TRA,35000,,35000,0
14503124,44995,TRA,35000,,35000,0
14503124,44995,TRA,35000,35,35000,0
14353131,44938,TRA,42000,35,35000,7000
14397951,44956,TRA,43000,35,35000,8000
14477630,44987,TRA,31000,34,34000,-3000
14528808,45006,TRA,35000,,35000,0
14528808,45006,TRA,35000,35,35000,0
14453543,44978,TRA,42000,38,38000,4000
14453543,44978,TRA,42000,,42000,0
14404525,44959,TRA,18000,12,12000,6000
14365544,44944,TC20,28315,20,20000,8315
14402415,44963,TC20,32900,32,32000,900
14344382,44936,CON20,15000,13,13000,2000
14508472,45000,TC20,28070,27,27000,1070
14516302,45008,TC20,27930,28,28000,-70
14508322,45001,TC20,27930,28,28000,-70
14516303,45008,TC20,27930,30,30000,-2070
14371865,44952,TC20,23930,24,24000,-70
14452379,44978,TC20,29000,27,27000,2000
14414096,44965,TC20,27930,27,27000,930
14507088,44999,TC20,5000,5,5000,0
14443628,44973,TC20,20000,4,4000,16000
14396074,44956,TC20,34000,29,29000,5000
14406247,44963,TC20,8875,8,8000,875
14510082,45006,TC20,27930,28,28000,-70
14446675,44979,TC20,27950,28,28000,-50
14472480,44986,TC20,5000,4,4000,1000
14451488,44978,TC20,5000,5,5000,0
14344534,44936,TC20,5000,5,5000,0
14339655,44935,TC20,5000,5,5000,0
14337921,44931,TRA,26000,11,11000,15000
14475047,44987,TRA,7000,6,6000,1000
14472491,44988,TRA,31000,,31000,0
14472491,44988,TRA,31000,27,27000,4000
14436337,44971,TRAM,35000,27,27000,8000
14498076,44998,TRA,17000,,17000,0
14498076,44998,TRA,17000,,17000,0
14498076,44998,TRA,17000,16,16000,1000
14473631,44985,TRA,30000,24,24000,6000
14414727,44963,TRA,31000,14,14000,17000
14475044,44987,TRA,7000,7,7000,0
14379693,44949,TRA,25000,18,18000,7000
14423199,44966,TRA,31000,20,20000,11000
14453551,44980,TRA,31000,25,25000,6000
14463951,44987,TRA,22000,7,7000,15000
14498078,44998,TRA,16000,16,16000,0
14498078,44998,TRA,16000,,16000,0
14440100,44972,TRA,31000,32,32000,-1000
14473052,44985,TRA,16000,17,17000,-1000
14465034,44981,TRA,7000,12,12000,-5000
14528375,45006,TRA,25000,,25000,0
14528375,45006,TRA,25000,9,9000,16000
14528375,45006,TRA,25000,9,9000,16000
14441052,44972,TRA,35000,32,32000,3000
14446970,44978,TRA,22000,17,17000,5000
14389306,44952,TRA,41000,35,35000,6000
14338737,44935,TRA,17000,7,7000,10000
14475062,44988,TRA,26000,21,21000,5000
14422179,44966,TRA,31000,24,24000,7000
14494478,44994,TRA,22000,21,21000,1000
14494478,44994,TRA,22000,,22000,0
14453563,44981,TRA,31000,18,18000,13000
14533807,45008,TRA,20500,,20500,0
14512684,45001,TRA,13000,,13000,0
14512684,45001,TRA,13000,13,13000,0
14516364,45001,TRA,33000,,33000,0
14516364,45001,TRA,33000,29,29000,4000
14490691,44995,TRA,32000,,32000,0
14490691,44995,TRA,32000,32,32000,0
14397384,44957,TRA,18000,12,12000,6000
14446958,44977,TRA,22000,13,13000,9000
14455668,44978,TRA,7000,14,14000,-7000
14452462,44979,TRA,17000,12,12000,5000
14494472,44995,TRA,32000,,32000,0
14494472,44995,TRA,32000,32,32000,0
14354780,44939,TRA,18000,12,12000,6000
14479930,44987,TRA,7000,7,7000,0
14503323,44997,TRA,32000,15,15000,17000
14330872,44928,TRA,39000,11,11000,28000
14346353,44935,TRA,32000,18,18000,14000
14462013,44980,TRA,8000,7,7000,1000
14391894,44953,TRA,15000,13,13000,2000
14454382,44978,TRA,7000,7,7000,0
14454382,44978,TRA,7000,7,7000,0
14494366,44993,TRA,8000,7,7000,1000
14368246,44944,TRA,15000,6,6000,9000
14371287,44945,TRA,15000,7,7000,8000
14357959,44939,TRA,18000,12,12000,6000
14489840,44992,TRA,9000,9,9000,0
14477607,44987,TRA,9000,,9000,0
14533757,45008,TRA,18500,,18500,0
14524351,45005,TRA,32000,30,30000,2000
14524351,45005,TRA,32000,,32000,0
14524351,45005,TRA,32000,,32000,0
14502310,44997,TRA,10000,,10000,0
14502310,44997,TRA,10000,,10000,0
14502310,44997,TRA,10000,,10000,0
14502310,44997,TRA,10000,7,7000,3000
14381080,44953,TC20,5000,5,5000,0
14437705,44971,FLA40,6000,6,6000,0
14440221,44972,FLA40,6000,3,3000,3000
14437746,44971,FLA40,6000,5,5000,1000
14472979,44988,CON45,4500,4,4000,500
14369660,44949,CON45,4500,4,4000,500
14332865,44935,TC26,35460,30,30000,5460
14446973,44978,TC20,38000,32,32000,6000
14479699,44988,TC20,5000,5,5000,0
14514923,45008,TC20,25750,26,26000,-250
14508594,45001,TC20,5000,5,5000,0
14398521,44963,TC20,28420,29,29000,-580
14461125,44985,TC20,31000,31,31000,0
14433635,44984,TC20,31000,31,31000,0
14347594,44938,TC20,32000,24,24000,8000
14398916,44959,TC20,31000,30,30000,1000
14398916,44959,TC20,31000,,31000,0
14463958,44985,TC20,29000,24,24000,5000
14370765,44950,TC26,28000,28,28000,0
14452260,44986,TC20,31000,31,31000,0
14527832,45009,TC20,32000,31,31000,1000
14502503,45001,CON20,7000,4,4000,3000
14505950,44998,TC20,5000,4,4000,1000
14505950,44998,TC20,5000,5,5000,0
14361090,44944,TC26,28540,24,24000,4540
14349209,44942,TC26,31000,31,31000,0
14458158,44981,TC26,5000,5,5000,0
14424871,44970,TC26,31000,31,31000,0
14399896,44963,TC26,31000,31,31000,0
14373043,44946,TC20,32690,28,28000,4690
14461524,44985,TC26,24640,25,25000,-360
14363323,44943,TC26,9000,5,5000,4000
14418592,44965,TC20,5000,4,4000,1000
14416384,44964,TC23,5000,4,4000,1000
14369773,44945,TC23,9000,4,4000,5000
14414784,44964,TC20,8890,4,4000,4890
14396723,44956,TC20,8890,4,4000,4890
14421543,44970,TC26,35620,36,36000,-380
14460910,44984,TC26,35580,30,30000,5580
14364787,44946,TC26,33800,33,33000,800
14516403,45002,TC26,31000,31,31000,0
14387118,44953,TC20,30220,30,30000,220
14324944,44928,TC26,31000,31,31000,0
14375104,44950,TC26,34220,30,30000,4220
14520397,45006,TC26,35680,30,30000,5680
14491744,44995,TC26,35600,32,32000,3600
14327451,44931,TC26,33640,32,32000,1640
14416540,44967,TC26,25931,25,25000,931
14390022,44964,TC20,5000,5,5000,0
14340786,44944,TC20,5000,5,5000,0
14446625,44981,TC20,5000,5,5000,0
14490697,44994,TC30,33000,,33000,0
14490697,44994,TC30,33000,31,31000,2000
14502557,45002,TC20,5000,5,5000,0
14446624,44984,TC20,5000,5,5000,0
14316530,44936,TC20,5000,5,5000,0
14357408,44958,TC20,5000,4,4000,1000
14357744,44943,TC30,38000,33,33000,5000
14498085,44998,TC30,33000,,33000,0
14498085,44998,TC30,33000,,33000,0
14498085,44998,TC30,33000,29,29000,4000
14458154,44981,TC26,5000,5,5000,0
14516745,45005,TC26,31420,35,35000,-3580
14464025,44984,TC26,31000,31,31000,0
14402019,44965,TC20,32320,32,32000,320
14492314,44995,TC26,31000,31,31000,0
14332863,44936,TC26,35820,35,35000,820
14381217,44960,TC20,31320,31,31000,320
14362722,44942,TC26,36000,31,31000,5000
14399693,44958,TC20,30320,30,30000,320
14391019,44956,TC20,9000,7,7000,2000
14422997,44966,TC20,5000,4,4000,1000
14390947,44953,TC23,8890,4,4000,4890
14337264,44935,TC20,5000,4,4000,1000
14337263,44935,TC20,5000,5,5000,0
14337254,44935,TC20,5000,5,5000,0
14337266,44935,TC20,5000,5,5000,0
14337265,44935,TC20,5000,4,4000,1000
14337267,44935,TC20,5000,5,5000,0
14337268,44935,TC20,5000,4,4000,1000
14458153,44981,TC26,5000,5,5000,0
14460942,44986,TC26,5000,5,5000,0
14458152,44981,TC26,5000,4,4000,1000
14458156,44981,TC26,5000,5,5000,0
14458155,44981,TC26,5000,5,5000,0
14332496,44936,CON30,30000,3,3000,27000
14332504,44937,CON30,30360,30,30000,360
14381029,44950,CON30,3000,3,3000,0
14389528,44956,CON30,26960,26,26000,960
14416686,44966,CON30,29035,29,29000,35
14371822,44952,CON30,30380,30,30000,380
14376267,44950,CON30,3000,4,4000,-1000
14470647,44985,CON30,4000,4,4000,0
14454020,44979,CON30,4000,4,4000,0
14345083,44935,CON30,4000,4,4000,0
14332505,44939,CON30,30340,30,30000,340
14443297,44974,CON30,4000,4,4000,0
14369669,44946,CON30,4000,4,4000,0
14387359,44952,CON30,30000,30,30000,0
14332498,44936,CON30,25840,26,26000,-160
14362422,44944,CON30,4000,4,4000,0
14389580,44960,CON30,30000,30,30000,0
14376265,44949,CON30,3000,4,4000,-1000
14457606,44981,CON30,4000,4,4000,0
14458134,44979,CON30,4000,4,4000,0
14478977,44987,CON30,27800,29,29000,-1200
14434729,44971,CON30,4000,5,5000,-1000
14332508,44937,CON30,27960,28,28000,-40
14473071,44993,CON30,30000,30,30000,0
14389585,44960,CON30,30000,30,30000,0
14366707,44945,CON30,4000,3,3000,1000
14478979,44992,CON30,26810,26,26000,810
14332500,44936,CON30,26680,28,28000,-1320
14454021,44979,CON30,4000,4,4000,0
14425118,44970,CON30,4000,4,4000,0
14421549,44967,CON30,4000,4,4000,0
14421548,44966,CON30,4000,4,4000,0
14425115,44967,CON30,4000,4,4000,0
14327447,44929,CON30,26320,26,26000,320
14434728,44971,CON30,4000,4,4000,0
14457607,44980,CON30,4000,4,4000,0
14433483,44971,CON30,4000,3,3000,1000
14339698,44932,CON30,4000,4,4000,0
14447180,44978,CON30,4000,4,4000,0
14502429,44998,CON30,4000,3,3000,1000
14389567,44959,CON30,27280,27,27000,280
14348295,44938,CON30,4000,4,4000,0
14403354,44963,CON30,27260,27,27000,260
14301856,44930,CON30,29600,30,30000,-400
14333182,44944,CON30,30340,31,31000,-660
14425116,44967,CON30,4000,4,4000,0
14458133,44980,CON30,4000,4,4000,0
14381028,44951,CON30,3000,4,4000,-1000
14372869,44949,CON30,4000,4,4000,0
14465478,44984,CON30,4000,4,4000,0
14347609,44936,CON30,4000,4,4000,0
14447173,44977,CON30,4000,4,4000,0
14390929,44953,CON30,1900,2,2000,-100
14353764,44942,CON30,4000,4,4000,0
14389568,44957,CON30,26860,26,26000,860
14327450,44929,CON30,27480,28,28000,-520
14390935,44956,CON30,3000,3,3000,0
14455578,44985,CON30,29560,30,30000,-440
14520989,45006,CON30,4000,4,4000,0
14387216,44952,CON30,3000,4,4000,-1000
14502472,44999,CON30,4000,4,4000,0
14433484,44972,CON30,4000,4,4000,0
14403351,44963,CON30,27500,28,28000,-500
14516295,45005,CON30,4000,4,4000,0
14332497,44936,CON30,29380,30,30000,-620
14458132,44980,CON30,4000,4,4000,0
14465477,44984,CON30,4000,4,4000,0
14376264,44949,CON30,3000,4,4000,-1000
14479070,44994,CON30,30000,30,30000,0
14436343,44972,CON30,4000,4,4000,0
14403358,44964,CON30,30000,30,30000,0
14366709,44945,CON30,4000,4,4000,0
14332501,44936,CON30,27200,27,27000,200
14516288,45001,CON30,4000,4,4000,0
14473074,44993,CON30,30000,30,30000,0
14458924,44980,CON30,30000,30,30000,0
14358045,44943,CON30,4000,4,4000,0
14420200,44965,CON30,26520,26,26000,520
14488023,44995,CON30,4000,4,4000,0
14348296,44938,CON30,4000,4,4000,0
14363395,44943,CON30,4000,5,5000,-1000
14363395,44943,CON30,4000,,4000,0
14363395,44943,CON30,4000,,4000,0
14455580,44985,CON30,30360,31,31000,-640
14384280,44951,CON30,3000,3,3000,0
14358044,44942,CON30,4000,4,4000,0
14402270,44959,CON30,29555,30,30000,-445
14478980,44992,CON30,25560,25,25000,560
14390928,44956,CON30,1900,2,2000,-100
14309848,44929,CON30,30140,30,30000,140
14478978,44987,CON30,25520,26,26000,-480
14444322,44974,CON30,30220,30,30000,220
14389564,44959,CON30,29220,29,29000,220
14338189,44937,CON30,28415,28,28000,415
14309849,44929,CON30,29220,28,28000,1220
14369671,44945,CON30,4000,4,4000,0
14358042,44943,CON30,4000,4,4000,0
14387218,44952,CON30,3000,3,3000,0
14473068,44992,CON30,30420,30,30000,420
14371821,44953,CON30,29300,32,32000,-2700
14424527,44967,CON30,1900,1,1000,900
14341703,44936,CON30,3000,3,3000,0
14462008,44984,CON30,3000,3,3000,0
14457604,44980,CON30,4000,4,4000,0
14403355,44963,CON30,27220,28,28000,-780
14403356,44964,CON30,30000,30,30000,0
14424810,44967,CON30,30000,30,30000,0
14529722,45007,CON30,3000,3,3000,0
14510350,45000,CON30,4000,4,4000,0
14369670,44945,CON30,4000,4,4000,0
14452253,44980,CON30,30000,30,30000,0
14433449,44970,CON30,4000,3,3000,1000
14452171,44980,CON30,30000,30,30000,0
14363396,44943,CON30,4000,4,4000,0
14433450,44970,CON30,4000,3,3000,1000
14384281,44951,CON30,3000,3,3000,0
14508294,45002,CON30,29260,31,31000,-1740
14462048,44984,CON30,4000,4,4000,0
14376266,44950,CON30,3000,4,4000,-1000
14510789,45000,CON30,3000,3,3000,0
14414373,44964,CON30,3000,4,4000,-1000
14414373,44964,CON30,3000,,3000,0
14373267,44946,CON30,3000,3,3000,0
14390339,44953,CON30,3000,3,3000,0
14369841,44946,CON30,3000,3,3000,0
14421533,44971,CON20,3700,4,4000,-300
14378393,44950,TC20,32940,28,28000,4940
14351750,44938,TC20,31500,31,31000,500
14446115,44974,TC20,24460,25,25000,-540
14418115,44967,TC26,28000,28,28000,0
14352654,44942,TC20,27460,28,28000,-540
14461154,44981,TC20,5000,5,5000,0
14455176,44978,TRA,28000,20,20000,8000
14472200,44985,TRA,34000,10,10000,24000
14472200,44985,TRA,34000,10,10000,24000
14498373,44994,TRA,28000,,28000,0
14498373,44994,TRA,28000,,28000,0
14498373,44994,TRA,28000,13,13000,15000
14330909,44928,TRA,32000,16,16000,16000
14357815,44943,TC20,5000,5,5000,0
14331753,44929,TC20,33000,28,28000,5000
14380625,44951,TC23,33000,33,33000,0
14527765,45007,TC20,5000,4,4000,1000
14527765,45007,TC20,5000,,5000,0
14406023,44960,TC20,31060,31,31000,60
14323016,44928,TC20,28100,28,28000,100
14490271,44993,TC23,32000,30,30000,2000
14328482,44929,TC23,32000,31,31000,1000
14417157,44965,TC23,32000,31,31000,1000
14388960,44956,TC23,32000,32,32000,0
14404529,44959,TC20,5000,5,5000,0
14512712,45001,TC20,5000,,5000,0
14512712,45001,TC20,5000,5,5000,0
14389578,44953,TC20,5000,5,5000,0
14351091,44938,TC20,36000,30,30000,6000
14361089,44942,TC20,36000,32,32000,4000
14436272,44971,TC20,5000,5,5000,0
14454976,44979,TC20,31480,31,31000,480
14527837,45008,TC20,27480,28,28000,-520
14345981,44935,TC26,32000,32,32000,0
14529323,45007,TC20,5000,4,4000,1000
14372038,44945,TC20,36000,,36000,0
14372038,44945,TC20,36000,32,32000,4000
14372038,44945,TC20,36000,,36000,0
14372038,44945,TC20,36000,,36000,0
14439609,44972,TC20,5000,4,4000,1000
14418221,44964,TC20,31000,32,32000,-1000
14513138,45002,TC20,27475,28,28000,-525
14348332,44938,TC26,28000,,28000,0
14348332,44938,TC26,28000,27,27000,1000
14392777,44958,TC20,24995,30,30000,-5005
14364848,44944,TC26,36000,31,31000,5000
14328658,44929,TC20,32475,32,32000,475
14408042,44965,TC20,36000,31,31000,5000
14433955,44973,TC20,5000,5,5000,0
14529790,45006,TC20,31000,,31000,0
14529790,45006,TC20,31000,31,31000,0
14401623,44959,TC26,26000,26,26000,0
14351045,44942,TRA,18000,31,31000,-13000
14351045,44942,TRA,18000,32,32000,-14000
14414452,44965,TC20,32475,32,32000,475
14444103,44978,TC20,31515,32,32000,-485
14515552,45001,TC20,31000,29,29000,2000
14515552,45001,TC20,31000,,31000,0
14514138,45001,TC20,31000,30,30000,1000
14514138,45001,TC20,31000,,31000,0
14487864,44992,TC20,27475,27,27000,475
14368764,44951,TC20,30660,30,30000,660
14508421,44999,TC20,29000,28,28000,1000
14508421,44999,TC20,29000,,29000,0
14508421,44999,TC20,29000,28,28000,1000
14424502,44966,TC20,28000,28,28000,0
14507087,45001,TC20,27700,27,27000,700
14327134,44928,TC20,31700,31,31000,700
14508358,44999,TC20,28700,28,28000,700
14463934,44985,TC26,28000,28,28000,0
14354614,44951,TC20,30760,30,30000,760
14444182,44977,TC20,27700,28,28000,-300
14327160,44928,TC20,31700,31,31000,700
14327160,44928,TC20,31700,,31700,0
14455126,44981,TC20,27700,27,27000,700
14362707,44950,TC20,28700,30,30000,-1300
14381445,44952,TC20,5000,5,5000,0
14442505,44977,TC20,5000,5,5000,0
14421547,44966,TC20,5000,5,5000,0
14336611,44931,TC20,30220,,30220,0
14399232,44963,TC20,28400,,28400,0
14419829,44970,TC20,28200,28,28000,200
14417434,44965,TC20,32140,31,31000,1140
14423464,44974,TC20,28920,29,29000,-80
14357976,44942,TC20,29020,25,25000,4020
14446790,44980,TC20,32020,33,33000,-980
14419766,44984,TC20,25000,29,29000,-4000
14368020,44944,TC20,5000,5,5000,0
14433451,44971,TC20,5000,4,4000,1000
14376296,44950,TC20,32500,33,33000,-500
14469574,44992,TC26,35400,30,30000,5400
14405782,44960,TC20,5000,6,6000,-1000
14366473,44944,TC20,5000,5,5000,0
14487699,44991,TC20,5000,5,5000,0
14367548,44946,TC26,34780,31,31000,3780
14510337,44999,TC20,5000,5,5000,0
14483188,44991,TC23,32000,35,35000,-3000
14455662,44980,TC20,5000,4,4000,1000
14355760,44942,TC20,5000,5,5000,0
14403406,44960,TC20,5000,5,5000,0
14361555,44942,TC20,5000,5,5000,0
14421568,44966,TC20,5000,4,4000,1000
14338756,44935,TC20,5000,5,5000,0
14487592,44995,TC20,5000,5,5000,0
14469578,44984,TC20,5000,6,6000,-1000
14483152,44988,TC20,5000,4,4000,1000
14391912,44953,TC20,5000,5,5000,0
14413958,44964,TC20,5000,5,5000,0
14461479,44981,TC20,5000,6,6000,-1000
14469579,44984,TC20,5000,5,5000,0
14487593,44994,TC20,5000,5,5000,0
14423314,44971,TC20,5000,5,5000,0
14381452,44953,TC20,5000,5,5000,0
14338755,44935,TC20,5000,5,5000,0
14408227,44963,TC20,5000,5,5000,0
14457496,44987,TC26,37240,31,31000,6240
14388865,44953,TC20,5000,6,6000,-1000
14419483,44965,TC20,5000,4,4000,1000
14367549,44944,TC26,32800,32,32000,800
14361557,44943,TC20,5000,5,5000,0
14341784,44935,TC20,5000,4,4000,1000
14361558,44942,TC20,5000,5,5000,0
14405780,44960,TC20,5000,4,4000,1000
14369900,44946,TC20,5000,5,5000,0
14457498,44986,TC26,36720,33,33000,3720
14419904,44970,TC20,5000,5,5000,0
14341785,44935,TC20,5000,5,5000,0
14501980,45000,TC26,35740,35,35000,740
14475092,44986,TC20,5000,5,5000,0
14389078,44953,TC20,5000,6,6000,-1000
14516294,45002,TC20,5000,6,6000,-1000
14516294,45002,TC20,5000,5,5000,0
14454221,44978,TC20,5000,4,4000,1000
14326680,44930,TC20,5000,5,5000,0
14517317,45002,TC20,5000,5,5000,0
14432885,44972,TC20,5000,5,5000,0
14432885,44972,TC20,5000,,5000,0
14348946,44939,TC20,5000,4,4000,1000
14524093,45007,TC20,5000,4,4000,1000
14396781,44966,TC20,20000,20,20000,0
14414791,44964,TC20,9000,4,4000,5000
14523492,45005,TC20,24500,23,23000,1500
14510206,45002,TC20,24000,23,23000,1000
14396430,44964,TC20,13000,13,13000,0
14432653,44970,TC20,24000,23,23000,1000
14477688,44993,TC20,24000,,24000,0
14477688,44993,TC20,24000,24,24000,0
14322564,44928,TC20,32000,32,32000,0
14386440,44958,TC20,28000,26,26000,2000
14346029,44936,TC20,5000,5,5000,0
14347458,44937,TC20,5000,5,5000,0
14417220,44966,TC20,5000,4,4000,1000
14481604,44988,TC20,5000,5,5000,0
14417392,44977,TC23,32000,32,32000,0
14346219,44936,TC20,29000,24,24000,5000
14450506,44977,TC20,24000,24,24000,0
14455647,44988,TC26,30000,30,30000,0
14393132,44957,TC26,5000,5,5000,0
14332185,44939,TC26,30000,30,30000,0
14337405,44942,TC26,32000,32,32000,0
14332197,44935,TC26,25616,25,25000,616
14368346,44949,TC26,33000,33,33000,0
14387938,44952,TC26,9000,5,5000,4000
14381353,44950,TC26,9000,4,4000,5000
14469987,44995,TC26,30000,30,30000,0
14380380,44958,TC25,30000,30,30000,0
14384537,44951,TC26,37000,30,30000,7000
14354897,44942,TC23,28000,23,23000,5000
14337911,44931,TC26,37000,32,32000,5000
14404531,44959,TC25,36000,31,31000,5000
14346567,44938,TC20,31500,28,28000,3500
14530206,45007,TC20,31000,31,31000,0
14494940,45008,TC23,32000,32,32000,0
14460808,44981,TC20,5000,5,5000,0
14350673,44951,TC20,27080,27,27000,80
14339180,44939,TC20,29390,29,29000,390
14534202,45009,TC20,29390,29,29000,390
14498371,44998,TC20,29390,29,29000,390
14469884,44986,TC20,29390,30,30000,-610
14481882,44992,TC26,36860,36,36000,860
14460911,44981,TC26,34520,34,34000,520
14348109,44939,TC26,34560,30,30000,4560
14421535,44966,TC26,34560,35,35000,-440
14528414,45009,TC26,34540,34,34000,540
14452371,44978,TC20,29000,,29000,0
14452371,44978,TC20,29000,29,29000,0
14332117,44931,TC26,34510,34,34000,510
14358289,44944,TC26,34630,30,30000,4630
14330726,44931,TC20,29600,30,30000,-400
14488658,44994,TC20,29600,30,30000,-400
14508592,45002,TC20,29600,30,30000,-400
14347483,44936,TC20,33000,28,28000,5000
14454087,44978,TC20,5000,4,4000,1000
14436437,44973,TC26,30000,30,30000,0
14330733,44937,TC20,31600,31,31000,600
14339179,44938,TC20,29600,30,30000,-400
14418152,44967,TC20,30590,30,30000,590
14398845,44960,TC20,29000,29,29000,0
14506441,44998,TC26,30000,30,30000,0
14324321,44929,TC26,32130,30,30000,2130
14508591,45002,TC20,29590,30,30000,-410
14423069,44967,TC20,33000,29,29000,4000
14528313,45008,TC20,29590,30,30000,-410
14503126,44999,TC20,29590,30,30000,-410
14457399,44980,TC20,29000,29,29000,0
14487440,44991,TC20,28000,,28000,0
14487440,44991,TC20,28000,28,28000,0
14348061,44942,TC20,23920,23,23000,920
14339178,44936,TC20,31170,,31170,0
14339178,44936,TC20,31170,31,31000,170
14527889,45006,TC20,27001,27,27000,1
14527889,45006,TC20,27001,,27001,0
14503164,44999,TC20,28250,28,28000,250
14508492,45001,TC20,24250,,24250,0
14423492,44967,TC20,6500,6,6000,500
14502126,44999,TC20,30000,30,30000,0
14390934,44958,TC23,32000,32,32000,0
14475514,44988,TC26,35480,30,30000,5480
14353233,44939,TC20,34240,34,34000,240
14358176,44942,TC20,33900,34,34000,-100
14477044,44991,TC20,27390,30,30000,-2610
14465292,44985,TC26,35860,30,30000,5860
14413983,44964,TC25,31000,31,31000,0
14383137,44953,TC20,33880,33,33000,880
14404124,44962,TC23,30500,28,28000,2500
14477043,44991,TC20,29020,30,30000,-980
14358288,44944,TC26,31685,31,31000,685
14498323,44998,TC26,35700,31,31000,4700
14387166,44953,TC23,31000,31,31000,0
14520399,45005,TC26,31000,31,31000,0
14401932,44966,TC20,31430,32,32000,-570
14491747,44995,TC26,34450,31,31000,3450
14354579,44943,TC20,23095,23,23000,95
14487374,44998,TC20,31980,31,31000,980
14347602,44938,TC20,30520,30,30000,520
14347782,44938,TC26,34140,34,34000,140
14482592,44992,TC20,28780,28,28000,780
14490397,44993,TC20,28250,30,30000,-1750
14473162,44987,TC23,31000,31,31000,0
14514102,45002,TC20,24000,24,24000,0
14446297,44978,TC20,29530,30,30000,-470
14398931,44958,TC20,32530,30,30000,2530
14472385,44987,TC20,24530,26,26000,-1470
14396567,44959,TC26,35000,30,30000,5000
14390568,44957,TC20,31040,31,31000,40
14508367,45000,TC26,33000,33,33000,0
14520401,45005,TC26,31000,30,30000,1000
14508481,45001,TC20,30040,30,30000,40
14513165,45001,TC23,34000,,34000,0
14513165,45001,TC23,34000,,34000,0
14513165,45001,TC23,34000,34,34000,0
14513165,45001,TC23,34000,,34000,0
14528267,45007,TC23,34000,,34000,0
14528267,45007,TC23,34000,,34000,0
14528267,45007,TC23,34000,,34000,0
14528267,45007,TC23,34000,34,34000,0
14362568,44944,TC23,31000,31,31000,0
14491770,44995,TC20,28970,29,29000,-30
14508486,45000,TC20,28970,29,29000,-30
14363386,44945,TC20,30040,30,30000,40
14324322,44929,TC26,35830,35,35000,830
14452627,44979,TC20,29450,30,30000,-550
14502350,44995,TC26,35000,35,35000,0
14491772,44995,TC20,29450,29,29000,450
14366722,44950,TC20,29470,29,29000,470
14508512,44998,TC20,35000,34,34000,1000
14508512,44998,TC20,35000,,35000,0
14478828,44991,TC20,32560,32,32000,560
14506851,45005,TC20,31560,32,32000,-440
14443355,44978,TC26,36000,36,36000,0
14371976,44951,TC26,34560,33,33000,1560
14442341,44974,TC20,29540,30,30000,-460
14327452,44930,TC26,33140,33,33000,140
14452197,44979,TC25,33280,33,33000,280
14502286,44995,TC23,35000,34,34000,1000
14502286,44995,TC23,35000,,35000,0
14418244,44970,TC20,30340,31,31000,-660
14399813,44963,TC25,32340,30,30000,2340
14346565,44938,TC23,33000,,33000,0
14502690,45002,CON30,4000,3,3000,1000
14463851,44984,TC20,5000,5,5000,0
14463851,44984,TC20,5000,,5000,0
14489849,44992,TC20,5000,,5000,0
14489849,44992,TC20,5000,4,4000,1000
14345960,44936,TC20,5000,5,5000,0
14416868,44972,TC20,29040,30,30000,-960
14368291,44956,TC20,29360,30,30000,-640
14487227,44991,TC20,5000,5,5000,0
14501923,45002,TC20,29360,30,30000,-640
14469471,44988,TC20,28530,30,30000,-1470
14339188,44942,TC20,28530,28,28000,530
14416000,44964,TC20,5000,4,4000,1000
14396075,44956,TC20,5000,5,5000,0
14324832,44935,TC20,28530,,28530,0
14436582,44979,TC20,28530,30,30000,-1470
14524127,45005,TC20,5000,4,4000,1000
14524127,45005,TC20,5000,,5000,0
14476969,44988,TC20,29100,30,30000,-900
14503125,44999,TC20,29100,30,30000,-900
14420278,44966,TC25,5000,4,4000,1000
14513859,45006,TC26,5000,5,5000,0
14427182,44967,TRA,34000,38,38000,-4000
14352583,44937,TRA,39000,,39000,0
14352583,44937,TRA,39000,,39000,0
14356013,44938,TRA,39000,35,35000,4000
14370584,44952,CON30,3000,4,4000,-1000
14336935,44943,CON30,3000,3,3000,0
14341572,44933,CON30,3000,3,3000,0
14422901,44970,CON30,3000,3,3000,0
14422901,44970,CON30,3000,,3000,0
14465499,44986,CON30,3000,4,4000,-1000
14479179,44999,CON30,29000,29,29000,0
14336947,44936,CON30,3000,3,3000,0
14336942,44938,CON30,3000,3,3000,0
14520376,45009,CON30,3000,3,3000,0
14451639,44980,CON30,3000,5,5000,-2000
14447111,44976,CON30,29820,,29820,0
14465498,44988,CON30,29000,30,30000,-1000
14370582,44957,CON30,3000,3,3000,0
14520384,45009,CON30,3000,4,4000,-1000
14370587,44951,CON30,3000,3,3000,0
14390197,44965,CON30,3000,3,3000,0
14515915,45002,CON30,29000,30,30000,-1000
14389898,44959,CON30,28000,30,30000,-2000
14370592,44946,CON30,3000,3,3000,0
14389894,44960,CON30,3000,30,30000,-27000
14479178,45001,CON30,29000,30,30000,-1000
14451642,44981,CON30,3000,3,3000,0
14465484,44984,CON30,28000,29,29000,-1000
14336926,44946,CON30,3000,3,3000,0
14336930,44944,CON30,29000,29,29000,0
14370571,44957,CON30,3000,3,3000,0
14336949,44937,CON30,3000,3,3000,0
14370588,44951,CON30,1900,3,3000,-1100
14479197,44992,CON30,27900,27,27000,900
14479192,44994,CON30,27900,3,3000,24900
14502708,44995,CON30,1900,2,2000,-100
14390214,44963,CON30,1900,4,4000,-2100
14336943,44937,CON30,3000,3,3000,0
14479169,45002,CON30,29000,30,30000,-1000
14479185,44998,CON30,28000,29,29000,-1000
14390193,44967,CON30,28000,,28000,0
14370585,44952,CON30,1900,4,4000,-2100
14515916,45001,CON30,1900,2,2000,-100
14370575,44956,CON30,3000,3,3000,0
14422876,44972,CON30,3000,3,3000,0
14370601,44945,CON30,1900,1,1000,900
14356961,44939,CON30,1900,1,1000,900
14370581,44952,CON30,3000,4,4000,-1000
14336937,44939,CON30,29000,29,29000,0
14422905,44967,CON30,3000,3,3000,0
14422903,44971,CON30,3000,3,3000,0
14496829,44995,CON30,28000,28,28000,0
14451644,44980,CON30,3000,3,3000,0
14520385,45007,CON30,27900,30,30000,-2100
14389896,44959,CON30,1900,4,4000,-2100
14422871,44971,CON30,28000,31,31000,-3000
14465502,44987,CON30,3000,4,4000,-1000
14336940,44938,CON30,1900,2,2000,-100
14389895,44958,CON30,26900,4,4000,22900
14479188,44994,CON30,1900,2,2000,-100
14336953,44936,CON30,3000,3,3000,0
14517050,45004,CON30,3000,3,3000,0
14520393,45007,CON30,3000,4,4000,-1000
14336934,44942,CON30,3000,3,3000,0
14389887,44960,CON30,3000,,3000,0
14389887,44960,CON30,3000,,3000,0
14451828,44978,CON30,28900,29,29000,-100
14451828,44978,CON30,28900,,28900,0
14422879,44972,CON30,28000,28,28000,0
14370577,44953,CON30,29000,29,29000,0
14370600,44945,CON30,13000,3,3000,10000
14465496,44988,CON30,28000,30,30000,-2000
14356960,44939,CON30,3000,3,3000,0
14327235,44930,CON30,3000,,3000,0
14496831,44994,CON30,3000,3,3000,0
14502162,44995,CON30,3000,3,3000,0
14451650,44978,CON30,3000,4,4000,-1000
14341495,44932,CON30,3000,3,3000,0
14389886,44959,CON30,17000,14,14000,3000
14451645,44979,CON30,3000,4,4000,-1000
14479190,44998,CON30,28000,30,30000,-2000
14479171,45005,CON30,3000,3,3000,0
14451629,44979,CON30,28000,28,28000,0
14390204,44963,CON30,3000,5,5000,-2000
14390204,44963,CON30,3000,,3000,0
14370590,44950,CON30,1900,2,2000,-100
14451646,44979,CON30,1900,2,2000,-100
14502132,44995,CON30,1900,2,2000,-100
14479191,44993,CON30,3000,4,4000,-1000
14422904,44970,CON30,3000,4,4000,-1000
14390199,44964,CON30,3000,3,3000,0
14390199,44964,CON30,3000,,3000,0
14520390,45006,CON30,3000,4,4000,-1000
14465488,44985,CON30,1900,4,4000,-2100
14465505,44986,CON30,1900,3,3000,-1100
14451649,44977,CON30,1900,4,4000,-2100
14390203,44964,CON30,1900,2,2000,-100
14390187,44966,CON30,26900,27,27000,-100
14336933,44943,CON30,1900,3,3000,-1100
14422842,44977,CON30,1900,2,2000,-100
14502130,44998,CON30,1900,2,2000,-100
14422911,44971,CON30,1900,4,4000,-2100
14327243,44929,CON30,1900,2,2000,-100
14370599,44946,CON30,1900,31,3100,-1200
14390196,44965,CON30,1900,2,2000,-100
14517049,45002,CON30,1900,4,4000,-2100
14336950,44935,CON30,1900,1,1000,900
14479170,45005,CON30,1900,2,2000,-100
14451648,44979,CON30,1900,2,2000,-100
14520387,45008,CON30,29000,30,30000,-1000
14336939,44939,CON30,28000,28,28000,0
14389890,44957,CON30,3000,3,3000,0
14479196,44994,CON30,1900,2,2000,-100
14479195,44992,CON40,29000,30,30000,-1000
14389882,44960,CON40,8000,4,4000,4000
14528145,45006,CON40,31500,27,27000,4500
14528145,45006,CON40,31500,,31500,0
14336928,44946,CON40,30000,30,30000,0
14370569,44956,CON40,4000,4,4000,0
14503191,44998,CON40,31500,31,31000,500
14336945,44937,CON40,4000,4,4000,0
14525116,45005,CON40,31500,30,30000,1500
14327234,44932,CON40,30000,30,30000,0
14370589,44949,CON40,4000,5,5000,-1000
14327237,44930,CON40,30000,30,30000,0
14327237,44930,CON40,30000,,30000,0
14389900,44958,CON40,4000,3,3000,1000
14422900,44971,CON40,29000,29,29000,0
14479174,45001,CON40,29000,29,29000,0
14390171,44966,CON40,29000,28,28000,1000
14370593,44949,CON40,4000,5,5000,-1000
14356963,44939,CON40,4000,4,4000,0
14479187,44993,CON40,30000,30,30000,0
14336929,44944,CON40,30000,30,30000,0
14390179,44966,CON40,29000,29,29000,0
14451634,44981,CON40,4000,4,4000,0
14422873,44974,CON40,29000,29,29000,0
14531384,45007,CON40,31500,31,31000,500
14507278,44999,CON40,31500,31,31000,500
14389884,44960,CON40,8000,4,4000,4000
14336927,44946,CON40,4000,4,4000,0
14526096,45005,CON40,31500,30,30000,1500
14390166,44960,CON40,4000,4,4000,0
14520389,45009,CON40,30000,30,30000,0
14520389,45009,CON40,30000,,30000,0
14479186,44994,CON40,30000,30,30000,0
14336931,44943,CON40,29000,4,4000,25000
14370579,44952,CON40,4000,4,4000,0
14336946,44936,CON40,4000,4,4000,0
14389892,44958,CON40,29000,28,28000,1000
14390169,44963,CON40,14000,4,4000,10000
14327239,44931,CON40,30000,30,30000,0
14370598,44945,CON40,30000,30,30000,0
14390168,44964,CON40,29000,30,30000,-1000
14479183,44995,CON40,30000,30,30000,0
14451647,44978,CON40,29000,29,29000,0
14479199,44987,CON30,29000,30,30000,-1000
14536055,45009,CON40,31500,,31500,0
14519846,45002,CON40,31500,32,32000,-500
14519847,45002,CON40,31500,31,31000,500
14465494,44988,CON40,30000,30,30000,0
14370583,44951,CON40,4000,4,4000,0
14336941,44938,CON40,4000,3,3000,1000
14496819,44995,CON40,31500,31,31000,500
14506373,44999,CON40,31500,31,31000,500
14422885,44985,CON40,29000,30,30000,-1000
14422907,44970,CON40,29000,29,29000,0
14347204,44937,TC20,5000,4,4000,1000
14349176,44937,CON20,5200,4,4000,1200
14524343,45005,CON40,10000,,10000,0
14524343,45005,CON40,10000,10,10000,0
14496472,44994,TC20,8000,,8000,0
14496472,44994,TC20,8000,9,9000,-1000
14413521,44963,TC20,14000,10,10000,4000
14364853,44944,TC20,5000,9,9000,-4000
14413642,44963,TC20,14000,10,10000,4000
14439998,44973,TC20,8000,10,10000,-2000
14336294,44931,TC20,5000,6,6000,-1000
14478992,44987,KTA,35000,16,16000,19000
14516988,45001,KTA,35000,23,23000,12000
14534420,45008,KTA,35000,16,16000,19000
14372151,44951,CON45,4500,4,4000,500
14386427,44951,KTA,36000,18,18000,18000
14416888,44964,KTA,25000,16,16000,9000
14401891,44958,KTA,36000,15,15000,21000
14345099,44935,KTA,36000,15,15000,21000
14330179,44928,KTA,36000,14,14000,22000
14371208,44945,KTA,36000,12,12000,24000
14357541,44939,KTA,36000,16,16000,20000
14513161,45000,KTA,25000,18,18000,7000
14488362,44991,KTA,25000,17,17000,8000
14434099,44970,KTA,25000,14,14000,11000
14446211,44974,KTA,25000,,25000,0
14446211,44974,KTA,25000,16,16000,9000
14460711,44980,KTA,25000,17,17000,8000
14471742,44985,KTA,25000,17,17000,8000
14527901,45006,KTA,25000,13,13000,12000
14524476,45005,KTA,35000,29,29000,6000
14469446,44984,KTA,25000,16,16000,9000
14453997,44978,KTA,25000,22,22000,3000
14439262,44972,KTA,25000,16,16000,9000
14483054,44988,KTA,35000,32,32000,3000
14502445,44995,KTA,35000,18,18000,17000
14353104,44938,KTA,36000,18,18000,18000
14367592,44944,KTA,36000,19,19000,17000
14338890,44931,KTA,36000,13,13000,23000
14408290,44960,KTA,25000,19,19000,6000
14422941,44966,KTA,25000,15,15000,10000
14396119,44956,KTA,36000,17,17000,19000
14382295,44950,KTA,36000,14,14000,22000
14380353,44949,KTA,36000,18,18000,18000
14392376,44953,KTA,36000,19,19000,17000
14413283,44963,KTA,25000,15,15000,10000
14336297,44930,KTA,36000,16,16000,20000
14364336,44943,KTA,36000,16,16000,20000
14350672,44937,KTA,36000,17,17000,19000
14490289,44992,KTA,29000,13,13000,16000
14517025,45001,KTA,25000,16,16000,9000
14503224,44995,KTA,25000,16,16000,9000
14426779,44967,KTA,25000,15,15000,10000
14442408,44973,KTA,25000,16,16000,9000
14475645,44986,KTA,31500,18,18000,13500
14456954,44979,KTA,25000,17,17000,8000
14537578,45009,KTA,25000,14,14000,11000
14463950,44981,KTA,25000,15,15000,10000
14477945,44987,KTA,25000,13,13000,12000
14451252,44977,KTA,25000,16,16000,9000
14435656,44971,KTA,25000,15,15000,10000
14510523,44999,KTA,25000,16,16000,9000
14493421,44993,KTA,25000,17,17000,8000
14362110,44942,KTA,36000,15,15000,21000
14347366,44936,KTA,36000,17,17000,19000
14331900,44929,KTA,36000,12,12000,24000
14419752,44965,KTA,25000,16,16000,9000
14405380,44959,KTA,25000,19,19000,6000
14388538,44952,KTA,36000,15,15000,21000
14375619,44946,KTA,36000,15,15000,21000
14389267,44952,TRA,32000,28,28000,4000
14371954,44945,CON20,13663,14,14000,-337
14338166,44936,CON30,4000,4,4000,0
14338167,44938,CON30,4000,4,4000,0
14388822,44956,CON30,4000,4,4000,0
14407803,44965,CON30,4000,4,4000,0
14338168,44938,CON30,4000,4,4000,0
14356828,44939,CON30,4000,4,4000,0
14388868,44957,CON30,4000,4,4000,0
14478728,44989,CON30,4000,4,4000,0
14366491,44943,TRA,35000,14,14000,21000
14491158,44992,TRA,32000,22,22000,10000
14524649,45005,TRA,32000,,32000,0
14524649,45005,TRA,32000,25,25000,7000
14524649,45005,TRA,32000,,32000,0
14477052,44986,TRA,32000,23,23000,9000
14386070,44951,TRA,32000,18,18000,14000
14393115,44953,TRA,35000,16,16000,19000
14347368,44936,TRA,32000,20,20000,12000
14346164,44936,TRA,32000,21,21000,11000
14346164,44936,TRA,32000,,32000,0
14400055,44957,TRA,32000,14,14000,18000
14421775,44965,TRA,28000,24,24000,4000
14413161,44963,TRA,35000,15,15000,20000
14488912,44991,TRA,28000,14,14000,14000
14514868,45000,TRA,32000,18,18000,14000
14529780,45006,TRA,32000,14,14000,18000
14393118,44953,TRA,39000,,39000,0
